Player,Nation,Pos,Squad,Age,Born,90s,Tkl,TklW,Def 3rd,Mid 3rd,Att 3rd,Tkl,Att,Tkl%,Past,Press,Succ,%,Def 3rd,Mid 3rd,Att 3rd,Blocks,Sh,ShSv,Pass,Int,Tkl+Int,Clr,Err
Max Aarons,eng ENG,DF,Norwich City,21,2000,32,69,37,50,19,0,37,58,63.8,21,434,113,26,255,140,39,86,22,1,64,56,125,69,0
Che Adams,sct SCO,FW,Southampton,25,1996,22.7,16,9,4,6,6,2,15,13.3,13,332,87,26.2,38,132,162,25,4,0,21,10,26,15,0
Rayan Aït Nouri,fr FRA,DF,Wolves,20,2001,20.3,76,43,54,14,8,28,45,62.2,17,402,135,33.6,231,116,55,34,3,0,31,38,114,32,1
Kristoffer Ajer,no NOR,DF,Brentford,23,1998,22.2,40,22,25,12,3,20,36,55.6,16,206,73,35.4,107,70,29,36,13,1,23,49,89,81,1
Nathan Aké,nl NED,DF,Manchester City,26,1995,10.3,15,5,6,8,1,4,7,57.1,3,70,23,32.9,26,37,7,12,5,0,7,18,33,31,0
Marc Albrighton,eng ENG,FWDF,Leicester City,31,1989,12.6,33,16,17,9,7,10,41,24.4,31,289,63,21.8,98,141,50,27,5,1,22,25,58,10,0
Thiago Alcántara,es ESP,MF,Liverpool,30,1991,17,58,40,17,31,10,12,40,30,28,319,117,36.7,86,163,70,26,2,0,24,35,93,18,2
Trent Alexander-Arnold,eng ENG,DF,Liverpool,22,1998,31.7,44,24,22,15,7,23,59,39,36,288,97,33.7,114,88,86,39,5,1,34,76,120,43,1
Alisson,br BRA,GK,Liverpool,28,1992,36,0,0,0,0,0,0,2,0,2,6,3,50,6,0,0,1,0,0,1,0,0,1,2
Allan,br BRA,MF,Everton,30,1991,24.3,77,61,31,41,5,26,88,29.5,62,648,204,31.5,260,327,61,46,9,0,37,42,119,40,0
Dele Alli,eng ENG,MF,Everton,25,1996,3.8,15,10,6,6,3,5,12,41.7,7,127,34,26.8,35,62,30,9,2,0,7,10,25,7,0
Dele Alli,eng ENG,MFFW,Tottenham,25,1996,7.3,19,7,11,6,2,5,17,29.4,12,209,55,26.3,81,92,36,25,5,0,20,17,36,12,0
Miguel Almirón,py PAR,MFFW,Newcastle Utd,27,1994,19.1,57,33,27,22,8,13,47,27.7,34,432,109,25.2,127,166,139,22,1,1,21,25,82,12,0
Marcos Alonso,es ESP,DF,Chelsea,30,1990,24.1,45,28,21,13,11,14,32,43.8,18,300,85,28.3,121,101,78,39,6,0,33,66,111,55,0
Steven Alzate,co COL,MF,Brighton,22,1998,4.5,9,8,3,5,1,3,5,60,2,79,20,25.3,30,37,12,5,1,0,4,14,23,10,0
Daniel Amartey,gh GHA,DF,Leicester City,26,1994,23.6,25,12,15,9,1,16,32,50,16,172,54,31.4,97,67,8,48,24,1,24,30,55,110,2
Joachim Andersen,dk DEN,DF,Crystal Palace,25,1996,32.4,36,23,26,10,0,14,28,50,14,157,58,36.9,95,55,7,41,21,0,20,60,96,156,2
Michail Antonio,jm JAM,FW,West Ham,31,1990,33,28,23,7,9,12,6,20,30,14,460,133,28.9,34,166,260,26,1,0,25,14,42,17,0
Cameron Archer,eng ENG,MFFW,Aston Villa,19,2001,0.3,0,0,0,0,0,0,0,,0,4,0,0,0,2,2,0,0,0,0,1,1,1,0
Alphonse Areola,fr FRA,GK,West Ham,28,1993,1,0,0,0,0,0,0,0,,0,0,0,,0,0,0,0,0,0,0,0,0,0,0
Adam Armstrong,eng ENG,FW,Southampton,24,1997,15.7,10,7,3,3,4,0,6,0,6,239,64,26.8,21,89,129,10,1,0,9,9,19,6,0
Stuart Armstrong,sct SCO,MF,Southampton,29,1992,16.4,26,15,14,5,7,7,29,24.1,22,266,85,32,76,120,70,17,1,0,16,14,40,15,0
Kepa Arrizabalaga,es ESP,GK,Chelsea,26,1994,4,0,0,0,0,0,0,0,,0,0,0,,0,0,0,0,0,0,0,0,0,0,0
Harrison Ashby,sct SCO,DF,West Ham,19,2001,0.1,0,0,0,0,0,0,0,,0,0,0,,0,0,0,1,0,0,1,1,1,0,0
Pierre-Emerick Aubameyang,ga GAB,FW,Arsenal,32,1989,11.5,12,7,5,5,2,2,6,33.3,4,201,53,26.4,23,78,100,19,3,0,16,1,13,3,0
Jordan Ayew,gh GHA,FW,Crystal Palace,29,1991,22.4,52,34,19,22,11,11,22,50,11,515,146,28.3,121,227,167,37,4,0,33,28,80,9,0
Luke Ayling,eng ENG,DF,Leeds United,29,1991,25.2,79,45,50,24,5,49,101,48.5,52,392,137,34.9,215,137,40,49,28,0,21,54,133,68,1
César Azpilicueta,es ESP,DF,Chelsea,31,1989,23,54,31,22,27,5,21,43,48.8,22,356,104,29.2,143,158,55,62,11,0,51,37,91,71,1
Daniel Bachmann,at AUT,GK,Watford,27,1994,12,0,0,0,0,0,0,0,,0,0,0,,0,0,0,0,0,0,0,0,0,0,0
Leon Bailey,jm JAM,FWMF,Aston Villa,23,1997,8.5,19,12,7,9,3,4,13,30.8,9,145,48,33.1,24,59,62,13,2,0,11,3,22,3,0
Eric Bailly,ci CIV,DF,Manchester Utd,27,1994,2.4,8,3,6,2,0,1,2,50,1,21,9,42.9,14,6,1,5,2,0,3,8,16,10,0
Folarin Balogun,eng ENG,FW,Arsenal,20,2001,0.8,0,0,0,0,0,0,0,,0,21,5,23.8,2,2,17,1,0,0,1,0,0,1,0
Patrick Bamford,eng ENG,FW,Leeds United,27,1993,6.2,3,2,1,2,0,1,4,25,3,111,38,34.2,4,47,60,6,3,0,3,3,6,8,0
Shandon Baptiste,gd GRN,MF,Brentford,23,1998,10.1,7,4,6,0,1,3,14,21.4,11,204,68,33.3,62,94,48,15,0,0,15,21,28,11,0
Ross Barkley,eng ENG,MF,Chelsea,27,1993,2,1,1,0,1,0,0,1,0,1,18,3,16.7,1,10,7,1,0,0,1,2,3,0,0
Ashley Barnes,eng ENG,FW,Burnley,31,1989,9,13,10,4,6,3,2,6,33.3,4,157,35,22.3,16,84,57,6,1,1,5,6,19,4,0
Harvey Barnes,eng ENG,FWMF,Leicester City,23,1997,23.3,31,13,9,12,10,5,25,20,20,295,89,30.2,73,118,104,26,1,0,25,10,41,6,0
Lewis Bate,eng ENG,MF,Leeds United,18,2002,1.6,1,0,0,0,1,0,6,0,6,73,10,13.7,21,48,4,2,0,0,2,5,6,2,0
Mads Bech Sørensen,dk DEN,DF,Brentford,22,1999,9.3,12,7,10,2,0,5,6,83.3,1,73,29,39.7,45,22,6,10,6,0,4,9,21,28,0
Jan Bednarek,pl POL,DF,Southampton,25,1996,29.2,37,21,23,13,1,18,37,48.6,19,238,76,31.9,130,102,6,64,30,1,34,95,132,169,0
Donny van de Beek,nl NED,MF,Everton,24,1997,5.4,15,9,8,6,1,6,15,40,9,100,26,26,27,52,21,7,3,0,4,9,24,5,0
Donny van de Beek,nl NED,MF,Manchester Utd,24,1997,0.8,5,3,3,2,0,1,1,100,0,16,6,37.5,5,6,5,2,1,0,1,2,7,2,0
Asmir Begović,ba BIH,GK,Everton,34,1987,3,0,0,0,0,0,0,0,,0,0,0,,0,0,0,0,0,0,0,0,0,2,0
Saïd Benrahma,dz ALG,FWMF,West Ham,25,1995,24.1,35,23,16,13,6,16,38,42.1,22,377,94,24.9,108,187,82,22,1,0,21,12,47,7,0
Rodrigo Bentancur,uy URU,MF,Tottenham,24,1997,15.1,37,15,15,14,8,12,33,36.4,21,327,79,24.2,113,175,39,32,10,0,22,18,55,28,0
Christian Benteke,be BEL,FW,Crystal Palace,30,1990,12.7,8,2,2,4,2,2,6,33.3,4,120,32,26.7,9,50,61,8,4,0,4,1,9,30,1
Jóhann Berg Guðmundsson,is ISL,MF,Burnley,30,1990,12.2,19,9,10,7,2,9,20,45,11,170,44,25.9,49,69,52,18,2,0,16,17,36,21,0
Steven Bergwijn,nl NED,FWMF,Tottenham,23,1997,6.3,5,4,2,1,2,1,7,14.3,6,84,16,19,15,34,35,4,0,0,4,4,9,9,0
Ryan Bertrand,eng ENG,DF,Leicester City,31,1989,3.7,9,4,1,7,1,4,5,80,1,75,25,33.3,40,24,11,11,3,0,8,3,12,7,0
Mads Bidstrup,dk DEN,MF,Brentford,20,2001,0.5,4,2,2,2,0,0,2,0,2,19,8,42.1,12,7,0,1,0,0,1,1,5,2,0
Yves Bissouma,ml MLI,MF,Brighton,24,1996,23.5,73,50,36,34,3,18,33,54.5,15,415,149,35.9,166,201,48,43,5,0,38,55,128,51,0
Willy Boly,ci CIV,DF,Wolves,30,1991,10,27,22,19,7,1,8,15,53.3,7,110,43,39.1,64,43,3,21,7,1,14,19,46,39,0
Jarrod Bowen,eng ENG,FW,West Ham,24,1996,33.1,39,26,19,13,7,15,44,34.1,29,559,119,21.3,162,240,157,47,2,0,45,38,77,8,0
Jarrad Branthwaite,eng ENG,DF,Everton,19,2002,4.3,3,2,3,0,0,1,7,14.3,6,41,16,39,29,12,0,7,2,0,5,8,11,16,0
Armando Broja,al ALB,FW,Southampton,19,2001,21.9,17,12,5,7,5,2,14,14.3,12,376,112,29.8,37,133,206,22,2,0,20,13,30,8,0
Josh Brownhill,eng ENG,MF,Burnley,25,1995,32.8,73,41,25,42,6,15,46,32.6,31,540,168,31.1,168,271,101,51,16,0,35,79,152,49,0
Lewis Brunt,eng ENG,MF,Leicester City,20,2000,0.3,0,0,0,0,0,0,0,,0,5,0,0,0,3,2,1,0,0,1,0,0,0,0
Bryan,es ESP,FWMF,Tottenham,20,2001,1,4,3,2,0,2,3,6,50,3,38,12,31.6,10,6,22,2,0,0,2,0,4,0,0
Emi Buendía,ar ARG,FWMF,Aston Villa,24,1996,21.1,52,31,25,19,8,15,44,34.1,29,441,108,24.5,112,205,124,24,5,0,19,18,70,6,0
Dan Burn,eng ENG,DF,Brighton,29,1992,11.4,24,15,12,8,4,6,18,33.3,12,140,45,32.1,61,63,16,29,12,0,17,32,56,52,2
Dan Burn,eng ENG,DF,Newcastle Utd,29,1992,16,25,12,18,6,1,8,12,66.7,4,144,56,38.9,89,50,5,33,16,0,17,29,54,114,0
Jack Butland,eng ENG,GK,Crystal Palace,28,1993,8.5,0,0,0,0,0,0,0,,0,0,0,,0,0,0,0,0,0,0,0,0,0,0
Sam Byram,eng ENG,DF,Norwich City,27,1993,11.4,28,15,21,6,1,14,26,53.8,12,139,34,24.5,78,46,15,31,11,0,20,38,66,51,0
Willy Caballero,ar ARG,GK,Southampton,39,1981,2,0,0,0,0,0,0,0,,0,0,0,,0,0,0,0,0,0,0,0,0,1,0
Moisés Caicedo,ec ECU,MF,Brighton,19,2001,7.3,20,12,11,6,3,6,14,42.9,8,141,44,31.2,36,75,30,13,4,0,9,12,32,11,0
Dominic Calvert-Lewin,eng ENG,FW,Everton,24,1997,14.3,14,11,2,5,7,2,6,33.3,4,198,49,24.7,11,93,94,11,3,0,8,6,20,12,0
Chem Campbell,wls WAL,MF,Wolves,18,2002,0.1,1,1,0,1,0,0,0,,0,1,1,100,0,1,0,0,0,0,0,0,1,0,0
João Cancelo,pt POR,DF,Manchester City,27,1994,35.9,89,54,31,36,22,35,83,42.2,48,347,119,34.3,106,138,103,45,4,1,41,75,164,56,0
Sergi Canós,es ESP,DF,Brentford,24,1997,23.1,57,22,28,19,10,23,60,38.3,37,460,113,24.6,197,175,88,40,3,0,37,33,90,38,0
Todd Cantwell,eng ENG,FWMF,Norwich City,23,1998,4.9,15,11,8,6,1,4,14,28.6,10,106,25,23.6,39,46,21,2,0,0,2,4,19,3,0
Matty Cash,pl POL,DF,Aston Villa,23,1997,37.5,90,44,53,33,4,41,74,55.4,33,511,142,27.8,268,193,50,91,19,0,72,90,180,95,0
Timothy Castagne,be BEL,DF,Leicester City,25,1995,23.6,66,29,33,26,7,23,44,52.3,21,349,108,30.9,150,152,47,53,8,0,45,38,104,65,2
Jonny Castro,es ESP,DF,Wolves,27,1994,11.4,27,21,15,11,1,10,20,50,10,175,58,33.1,86,63,26,19,3,0,16,13,40,7,0
Craig Cathcart,nir NIR,DF,Watford,32,1989,26.6,33,15,26,7,0,16,34,47.1,18,165,51,30.9,117,45,3,55,32,0,23,38,71,129,2
Edinson Cavani,uy URU,FW,Manchester Utd,34,1987,8.5,4,2,0,3,1,3,6,50,3,105,39,37.1,14,36,55,9,0,0,9,9,13,7,0
Kayky Chagas,br BRA,FW,Manchester City,18,2003,0.1,0,0,0,0,0,0,0,,0,3,0,0,1,1,1,0,0,0,0,0,0,0,0
Trevoh Chalobah,eng ENG,DF,Chelsea,22,1999,16.1,38,21,16,18,4,20,30,66.7,10,165,60,36.4,64,86,15,20,9,1,11,33,71,65,1
Calum Chambers,eng ENG,DF,Aston Villa,26,1995,9.2,20,11,11,7,2,5,7,71.4,2,94,31,33,50,40,4,21,10,0,11,11,31,59,0
Calum Chambers,eng ENG,DF,Arsenal,26,1995,1.9,2,1,2,0,0,1,3,33.3,2,24,5,20.8,18,5,1,11,3,0,8,3,5,7,1
Daniel Chesters,eng ENG,MF,West Ham,19,2002,0,0,0,0,0,0,0,0,,0,0,0,,0,0,0,0,0,0,0,0,0,0,0
Ben Chilwell,eng ENG,DF,Chelsea,24,1996,6,10,5,3,6,1,0,5,0,5,92,31,33.7,34,36,22,10,0,0,10,6,16,15,1
Chiquinho,pt POR,DFMF,Wolves,21,2000,2.3,9,6,3,6,0,3,4,75,1,58,14,24.1,14,29,15,3,0,0,3,6,15,3,0
Hamza Choudhury,eng ENG,DFMF,Leicester City,23,1997,3.2,8,2,3,5,0,2,5,40,3,42,6,14.3,15,24,3,5,0,0,5,16,24,12,0
Andreas Christensen,dk DEN,DF,Chelsea,25,1996,16.6,18,12,11,4,3,10,15,66.7,5,148,51,34.5,84,52,12,30,9,0,21,52,70,87,1
Carney Chukwuemeka,lk SRI,MFFW,Aston Villa,17,2003,3.3,3,2,1,2,0,2,6,33.3,4,86,25,29.1,23,48,15,3,0,0,3,4,7,1,0
Ciaran Clark,ie IRL,DF,Newcastle Utd,31,1989,11.3,17,13,9,6,2,9,15,60,6,76,27,35.5,53,19,4,14,10,0,4,15,32,50,0
Tom Cleverley,eng ENG,MF,Watford,31,1989,18,34,27,18,12,4,10,32,31.3,22,372,106,28.5,116,190,66,28,7,1,21,27,61,19,1
Nathaniel Clyne,eng ENG,DF,Crystal Palace,30,1991,15,22,11,9,12,1,7,15,46.7,8,128,43,33.6,64,45,19,10,2,0,8,33,55,31,0
Conor Coady,eng ENG,DF,Wolves,28,1993,37.3,31,18,20,10,1,12,26,46.2,14,197,68,34.5,124,68,5,64,50,3,14,44,75,150,0
Séamus Coleman,ie IRL,DF,Everton,32,1988,29.5,72,42,41,20,11,29,47,61.7,18,336,124,36.9,159,130,47,59,13,0,46,54,126,75,1
Nathan Collins,ie IRL,DF,Burnley,20,2001,18.6,30,23,24,4,2,9,23,39.1,14,161,54,33.5,103,46,12,48,26,1,22,37,67,102,1
Aaron Connolly,ie IRL,FW,Brighton,21,2000,1.7,0,0,0,0,0,0,1,0,1,27,5,18.5,4,11,12,2,0,0,2,0,0,0,0
Liam Cooper,sct SCO,DF,Leeds United,29,1991,20.2,35,18,21,13,1,15,27,55.6,12,201,74,36.8,123,75,3,32,18,0,14,40,75,117,3
Jack Cork,eng ENG,MF,Burnley,32,1989,18.6,17,8,4,10,3,5,24,20.8,19,343,94,27.4,107,176,60,26,5,0,21,34,51,27,0
Maxwel Cornet,ci CIV,FWMF,Burnley,24,1996,19.6,20,11,7,7,6,4,11,36.4,7,303,84,27.7,68,127,108,14,4,0,10,11,31,16,0
Hélder Costa,ao ANG,MF,Leeds United,27,1994,0.2,0,0,0,0,0,0,2,0,2,9,2,22.2,1,5,3,0,0,0,0,0,0,0,0
Vladimír Coufal,cz CZE,DF,West Ham,28,1992,24.5,44,22,25,11,8,16,37,43.2,21,301,79,26.2,141,98,62,50,9,0,41,34,78,74,0
Philippe Coutinho,br BRA,MFFW,Aston Villa,29,1992,14.8,20,11,5,8,7,7,14,50,7,221,48,21.7,51,110,60,17,1,0,16,8,28,3,0
Aaron Cresswell,eng ENG,DF,West Ham,31,1989,30.3,30,19,20,8,2,14,27,51.9,13,213,67,31.5,111,73,29,48,17,0,31,43,73,76,1
Charlie Cresswell,eng ENG,DF,Leeds United,18,2002,1.6,7,3,4,3,0,3,3,100,0,29,5,17.2,14,15,0,2,1,0,1,4,11,10,0
Cucho,co COL,FWMF,Watford,22,1999,12.7,16,5,8,6,2,4,32,12.5,28,260,57,21.9,70,109,81,12,1,0,11,11,27,10,0
Marc Cucurella,es ESP,DF,Brighton,23,1998,34.3,88,62,36,38,14,48,77,62.3,29,534,201,37.6,215,218,101,72,15,2,57,72,160,66,0
Luke Cundle,eng ENG,MF,Wolves,19,2002,2,4,3,0,4,0,1,1,100,0,43,9,20.9,15,22,6,1,0,0,1,2,6,2,0
Patson Daka,zm ZAM,FW,Leicester City,22,1998,12.9,17,11,4,9,4,1,13,7.7,12,233,77,33,19,100,114,11,0,0,11,3,20,8,0
Stuart Dallas,nir NIR,DFMF,Leeds United,30,1991,32.4,91,47,59,26,6,48,115,41.7,67,531,177,33.3,262,212,57,64,16,1,48,78,169,66,0
Diogo Dalot,pt POR,DF,Manchester Utd,22,1999,20,58,33,34,15,9,27,44,61.4,17,232,72,31,110,84,38,37,12,3,25,44,102,61,0
Karl Darlow,eng ENG,GK,Newcastle Utd,30,1990,8,0,0,0,0,0,0,0,,0,0,0,,0,0,0,0,0,0,0,0,0,1,0
Josh Dasilva,eng ENG,MFFW,Brentford,22,1998,2.9,4,2,1,1,2,2,6,33.3,4,55,12,21.8,14,28,13,8,1,0,7,4,8,7,0
Ben Davies,wls WAL,DF,Tottenham,28,1993,28.2,40,18,18,15,7,12,34,35.3,22,269,86,32,133,92,44,39,18,2,21,45,85,93,0
Tom Davies,eng ENG,MF,Everton,23,1998,2.6,4,2,1,2,1,1,5,20,4,49,13,26.5,19,21,9,4,1,0,3,8,12,7,0
Keinan Davis,eng ENG,FW,Aston Villa,23,1998,0.1,0,0,0,0,0,0,0,,0,1,0,0,0,0,1,0,0,0,0,0,0,0,0
Craig Dawson,eng ENG,DF,West Ham,31,1990,30.6,33,21,20,13,0,12,27,44.4,15,199,67,33.7,126,64,9,66,55,0,11,30,63,145,1
Kevin De Bruyne,be BEL,MF,Manchester City,30,1991,24.5,22,14,3,10,9,10,41,24.4,31,361,98,27.1,46,149,166,34,2,0,32,14,36,18,0
Troy Deeney,eng ENG,FW,Watford,33,1988,0.3,0,0,0,0,0,0,1,0,1,7,2,28.6,1,2,4,0,0,0,0,0,0,3,0
Liam Delap,eng ENG,FW,Manchester City,18,2003,0.1,0,0,0,0,0,0,1,0,1,2,0,0,0,1,1,0,0,0,0,0,0,0,0
Fabian Delph,eng ENG,MF,Everton,31,1989,7.4,19,13,8,9,2,6,22,27.3,16,127,39,30.7,35,77,15,13,5,0,8,19,38,9,0
Leander Dendoncker,be BEL,MF,Wolves,26,1995,21.7,45,24,24,20,1,18,37,48.6,19,442,120,27.1,185,201,56,47,11,0,36,24,69,33,0
Emmanuel Dennis,ng NGA,FWMF,Watford,23,1997,28.7,46,28,24,14,8,13,42,31,29,563,146,25.9,124,249,190,35,2,0,33,25,71,14,0
Kiernan Dewsbury-Hall,eng ENG,MF,Leicester City,22,1998,23.4,40,25,24,12,4,13,35,37.1,22,468,113,24.1,155,183,130,46,8,0,38,27,67,28,1
Ibrahima Diallo,fr FRA,MF,Southampton,22,1999,11.4,27,20,12,11,4,8,24,33.3,16,229,68,29.7,76,114,39,10,0,0,10,17,44,9,0
Rúben Dias,pt POR,DF,Manchester City,24,1997,26.7,34,27,12,18,4,7,16,43.8,9,153,68,44.4,57,78,18,28,13,0,15,38,72,78,1
Luis Díaz,co COL,FW,Liverpool,24,1997,10.6,12,10,4,4,4,3,10,30,7,163,59,36.2,26,64,73,9,1,0,8,4,16,2,0
Eric Dier,eng ENG,DF,Tottenham,27,1994,34.1,25,13,11,11,3,4,13,30.8,9,181,70,38.7,93,79,9,56,38,1,18,47,72,168,0
Lucas Digne,fr FRA,DF,Aston Villa,28,1993,14.1,19,10,12,4,3,7,18,38.9,11,157,34,21.7,74,52,31,29,8,0,21,32,51,42,0
Lucas Digne,fr FRA,DF,Everton,28,1993,13,35,17,26,5,4,22,30,73.3,8,161,43,26.7,80,50,31,28,5,0,23,31,66,30,0
Issa Diop,fr FRA,DF,West Ham,24,1997,10.7,9,3,4,5,0,2,10,20,8,72,28,38.9,41,30,1,23,15,0,8,17,26,44,0
Moussa Djenepo,ml MLI,MF,Southampton,23,1998,5.1,13,8,6,6,1,5,12,41.7,7,104,25,24,46,39,19,9,1,0,8,9,22,3,0
Lewis Dobbin,eng ENG,FWMF,Everton,18,2003,0.4,2,2,0,1,1,0,2,0,2,19,5,26.3,4,7,8,0,0,0,0,1,3,0,0
Matt Doherty,ie IRL,DF,Tottenham,29,1992,9.7,18,12,9,8,1,7,12,58.3,5,120,42,35,50,54,16,24,2,0,22,17,35,15,0
Gabriel Dos Santos,br BRA,DF,Arsenal,23,1997,34,57,37,39,14,4,23,35,65.7,12,222,86,38.7,131,77,14,49,28,0,21,39,96,117,3
Abdoulaye Doucouré,ml MLI,MF,Everton,28,1993,28.2,76,45,37,36,3,26,70,37.1,44,656,179,27.3,248,308,100,42,8,0,34,41,117,33,0
Kieran Dowell,eng ENG,FWMF,Norwich City,23,1997,10.1,17,7,6,8,3,8,32,25,24,270,49,18.1,67,121,82,10,1,0,9,9,26,2,0
Cody Drameh,eng ENG,DF,Leeds United,19,2001,1.4,6,3,4,2,0,2,4,50,2,29,8,27.6,16,10,3,2,0,0,2,3,9,2,0
Martin Dúbravka,sk SVK,GK,Newcastle Utd,32,1989,26,0,0,0,0,0,0,2,0,2,5,1,20,5,0,0,0,0,0,0,0,0,0,0
Shane Duffy,ie IRL,DF,Brighton,29,1992,16,16,9,12,1,3,5,13,38.5,8,85,19,22.4,50,31,4,35,19,1,16,18,34,91,1
Paul Dummett,wls WAL,DF,Newcastle Utd,29,1991,2.2,9,4,6,2,1,5,8,62.5,3,31,12,38.7,15,13,3,3,0,0,3,4,13,9,1
Lewis Dunk,eng ENG,DF,Brighton,29,1991,28.6,20,11,9,10,1,6,13,46.2,7,125,48,38.4,74,41,10,42,27,0,15,46,66,119,3
Ederson,br BRA,GK,Manchester City,27,1993,37,0,0,0,0,0,0,2,0,2,5,0,0,5,0,0,0,0,0,0,0,0,0,1
Odsonne Édouard,fr FRA,FW,Crystal Palace,23,1998,17.4,17,13,2,7,8,2,19,10.5,17,354,106,29.9,45,146,163,24,5,0,19,10,27,17,0
CJ Egan-Riley,eng ENG,DF,Manchester City,18,2003,0,1,1,1,0,0,1,1,100,0,0,0,,0,0,0,0,0,0,0,0,1,0,0
Anthony Elanga,se SWE,FW,Manchester Utd,19,2002,13.5,25,17,12,10,3,8,26,30.8,18,289,80,27.7,93,124,72,24,2,0,22,19,44,6,0
Harvey Elliott,eng ENG,MF,Liverpool,18,2003,3.8,3,1,1,0,2,1,7,14.3,6,94,21,22.3,21,50,23,9,1,0,8,3,6,4,0
Mohamed Elneny,eg EGY,MF,Arsenal,29,1992,9,17,9,10,6,1,3,7,42.9,4,108,38,35.2,49,50,9,9,1,0,8,18,35,12,0
Mohamed Elyounoussi,no NOR,MFFW,Southampton,26,1994,22.7,46,33,14,24,8,10,31,32.3,21,499,156,31.3,144,235,120,37,4,0,33,19,65,24,0
Emerson,br BRA,DF,Tottenham,22,1999,25.4,86,39,56,24,6,28,60,46.7,32,500,126,25.2,245,177,78,56,4,0,52,35,121,79,0
Christian Eriksen,dk DEN,MF,Brentford,29,1992,10.4,18,10,7,8,3,9,13,69.2,4,150,32,21.3,38,86,26,13,1,0,12,10,28,11,0
Oghenekaro Etebo,ng NGA,MF,Watford,25,1995,4.5,12,10,5,7,0,4,7,57.1,3,65,22,33.8,29,32,4,5,1,0,4,8,20,6,0
Jonny Evans,nir NIR,DF,Leicester City,33,1988,15,27,18,18,7,2,16,28,57.1,12,123,49,39.8,77,41,5,22,13,0,9,31,58,61,0
Eberechi Eze,eng ENG,MFFW,Crystal Palace,23,1998,6.7,10,5,4,3,3,6,12,50,6,86,24,27.9,18,48,20,7,1,0,6,8,18,1,0
Łukasz Fabiański,pl POL,GK,West Ham,36,1985,37,0,0,0,0,0,0,0,,0,1,1,100,1,0,0,0,0,0,0,0,0,0,0
Fabinho,br BRA,MF,Liverpool,27,1993,25.7,57,37,17,33,7,19,62,30.6,43,413,131,31.7,126,225,62,51,10,0,41,56,113,30,0
Kiko Femenía,es ESP,DF,Watford,30,1991,23.8,43,26,29,11,3,24,41,58.5,17,227,75,33,112,85,30,39,10,0,29,63,106,61,0
Evan Ferguson,ie IRL,MF,Brighton,16,2004,0.3,0,0,0,0,0,0,0,,0,1,0,0,0,0,1,0,0,0,0,0,0,0,0
Nathan Ferguson,eng ENG,DF,Crystal Palace,20,2000,0.1,0,0,0,0,0,0,0,,0,1,0,0,1,0,0,0,0,0,0,0,0,0,0
Bruno Fernandes,pt POR,MF,Manchester Utd,26,1994,34.6,59,45,30,22,7,24,74,32.4,50,610,172,28.2,120,290,200,29,0,0,29,38,97,40,3
Álvaro Fernández,es ESP,GK,Brentford,23,1998,12,0,0,0,0,0,0,0,,0,0,0,,0,0,0,0,0,0,0,0,0,0,2
Federico Fernández,ar ARG,DF,Newcastle Utd,32,1989,5.8,1,1,0,1,0,0,6,0,6,33,4,12.1,21,9,3,11,9,0,2,13,14,23,0
Fernandinho,br BRA,MFDF,Manchester City,36,1985,10.7,23,16,8,13,2,6,19,31.6,13,130,45,34.6,42,74,14,6,3,0,3,14,37,23,1
Roberto Firmino,br BRA,FW,Liverpool,29,1991,11,34,21,5,17,12,4,15,26.7,11,249,85,34.1,32,114,103,20,0,0,20,4,38,3,0
Junior Firpo,es ESP,DF,Leeds United,24,1996,19,73,38,41,27,5,33,68,48.5,35,356,103,28.9,184,130,42,37,8,1,29,33,106,46,0
Ashley Fletcher,eng ENG,FW,Watford,25,1995,0.3,2,2,2,0,0,1,1,100,0,9,1,11.1,5,3,1,1,1,0,0,0,2,0,0
Phil Foden,eng ENG,FW,Manchester City,21,2000,23.6,19,15,8,5,6,7,10,70,3,410,135,32.9,44,132,234,12,2,0,10,17,36,1,0
Wesley Fofana,fr FRA,DF,Leicester City,20,2000,7,10,5,9,1,0,7,9,77.8,2,56,22,39.3,38,18,0,6,2,0,4,16,26,28,1
Pablo Fornals,es ESP,FWMF,West Ham,25,1996,31.1,51,34,22,18,11,26,87,29.9,61,664,179,27,190,299,175,52,3,0,49,47,98,16,0
Adam Forshaw,eng ENG,MF,Leeds United,29,1991,17,51,28,20,29,2,21,48,43.8,27,408,124,30.4,127,215,66,19,1,0,18,30,81,20,1
Marcus Forss,fi FIN,FWMF,Brentford,22,1999,2.3,4,2,0,3,1,2,4,50,2,70,21,30,11,29,30,3,0,0,3,2,6,0,0
Fraser Forster,eng ENG,GK,Southampton,33,1988,19,1,0,1,0,0,0,1,0,1,3,1,33.3,3,0,0,0,0,0,0,0,1,4,1
Ben Foster,eng ENG,GK,Watford,38,1983,26,0,0,0,0,0,0,3,0,3,7,1,14.3,7,0,0,0,0,0,0,0,0,6,2
Tariqe Fosu,gh GHA,DF,Brentford,25,1995,0.2,0,0,0,0,0,0,0,,0,5,0,0,0,2,3,1,0,0,1,0,0,0,0
Ryan Fraser,sct SCO,FWMF,Newcastle Utd,27,1994,16.3,13,4,8,5,0,4,16,25,12,166,42,25.3,33,71,62,14,1,0,13,16,29,9,0
Fred,br BRA,MF,Manchester Utd,28,1993,22.5,66,38,29,28,9,19,71,26.8,52,554,141,25.5,193,298,63,47,14,0,33,49,115,30,0
Ryan Fredericks,eng ENG,DF,West Ham,28,1992,3.4,4,2,4,0,0,2,4,50,2,24,5,20.8,13,7,4,4,1,0,3,6,10,9,1
Leo Fuhr Hjelde,no NOR,DF,Leeds United,17,2003,1.7,4,2,4,0,0,3,3,100,0,30,11,36.7,13,12,5,3,3,0,0,4,8,8,0
Conor Gallagher,eng ENG,MF,Crystal Palace,21,2000,31.6,69,44,33,20,16,14,61,23,47,782,221,28.3,208,362,212,56,10,0,46,43,112,27,0
Alejandro Garnacho,es ESP,FW,Manchester Utd,17,2004,0.1,0,0,0,0,0,0,1,0,1,9,0,0,4,4,1,0,0,0,0,0,0,0,0
Dwight Gayle,eng ENG,FW,Newcastle Utd,30,1990,0.4,1,0,0,1,0,0,0,,0,18,5,27.8,1,12,5,0,0,0,0,1,2,0,0
Jean-Philippe Gbamin,ci CIV,MF,Everton,25,1995,0.7,2,1,1,1,0,0,1,0,1,14,7,50,8,3,3,0,0,0,0,0,2,1,0
David de Gea,es ESP,GK,Manchester Utd,30,1990,38,0,0,0,0,0,0,0,,0,1,0,0,1,0,0,0,0,0,0,0,0,0,0
Joe Gelhardt,eng ENG,FWMF,Leeds United,19,2002,8.3,12,6,4,2,6,3,10,30,7,204,68,33.3,19,93,92,8,0,0,8,4,16,3,0
Anwar El Ghazi,nl NED,FWMF,Aston Villa,26,1995,4.3,3,3,1,2,0,2,6,33.3,4,48,18,37.5,7,24,17,5,0,0,5,2,5,2,0
Anwar El Ghazi,nl NED,FW,Everton,26,1995,0.1,1,1,1,0,0,1,1,100,0,10,3,30,2,3,5,2,0,0,2,1,2,0,0
Saman Ghoddos,ir IRN,DFMF,Brentford,27,1993,6,17,8,8,7,2,8,12,66.7,4,117,26,22.2,37,48,32,13,0,0,13,7,24,13,0
Dimitris Giannoulis,gr GRE,DF,Norwich City,25,1995,13,40,23,22,16,2,22,35,62.9,13,204,54,26.5,105,69,30,38,6,0,32,36,76,31,0
Morgan Gibbs-White,eng ENG,FWMF,Wolves,21,2000,0.1,0,0,0,0,0,0,0,,0,3,0,0,1,1,1,1,0,0,1,0,0,0,0
Ben Gibson,eng ENG,DF,Norwich City,28,1993,27.7,21,17,16,5,0,5,11,45.5,6,152,51,33.6,97,49,6,56,33,0,23,48,69,159,1
Billy Gilmour,sct SCO,MF,Norwich City,20,2001,20.6,48,22,19,24,5,15,41,36.6,26,495,101,20.4,203,235,57,23,5,0,18,33,81,32,0
Ben Godfrey,eng ENG,DF,Everton,23,1998,22.5,53,26,29,19,5,16,30,53.3,14,266,89,33.5,134,109,23,48,20,0,28,48,101,98,3
André Gomes,pt POR,MF,Everton,28,1993,6.9,15,9,6,5,4,7,22,31.8,15,198,51,25.8,70,92,36,13,2,0,11,11,26,3,1
Toti Gomes,pt POR,DF,Wolves,22,1999,4,7,3,6,1,0,3,8,37.5,5,34,15,44.1,19,10,5,10,2,0,8,10,17,20,0
Joe Gomez,eng ENG,DF,Liverpool,24,1997,3.7,7,4,5,0,2,2,6,33.3,4,42,16,38.1,18,16,8,3,1,0,2,12,19,8,0
Charlie Goode,eng ENG,DF,Brentford,25,1995,5,8,5,6,2,0,4,4,100,0,36,15,41.7,20,13,3,5,2,0,3,5,13,12,0
Anthony Gordon,eng ENG,MFFW,Everton,20,2001,25.4,62,36,29,23,10,22,63,34.9,41,596,154,25.8,153,275,168,58,5,0,53,36,98,8,0
Kaide Gordon,eng ENG,FW,Liverpool,16,2004,0.1,1,0,0,0,1,1,1,100,0,6,3,50,0,1,5,0,0,0,0,0,1,0,0
Dan Gosling,eng ENG,MF,Watford,31,1990,1.8,2,1,2,0,0,1,6,16.7,5,28,7,25,9,13,6,1,0,0,1,1,3,3,0
Demarai Gray,eng ENG,MFFW,Everton,25,1996,26,33,19,13,12,8,15,32,46.9,17,339,109,32.2,83,133,123,38,2,0,36,16,49,15,1
Jack Grealish,eng ENG,FW,Manchester City,25,1995,21.3,20,15,4,12,4,3,12,25,9,269,105,39,39,90,140,20,2,0,18,16,36,7,0
Mason Greenwood,eng ENG,FWMF,Manchester Utd,19,2001,14.1,16,8,8,2,6,5,12,41.7,7,154,40,26,35,59,60,5,0,0,5,4,20,5,0
Sam Greenwood,eng ENG,MFFW,Leeds United,19,2002,2.6,8,2,0,7,1,3,7,42.9,4,73,16,21.9,7,42,24,2,1,0,1,2,10,3,0
Pascal Groß,de GER,MFDF,Brighton,30,1991,22.6,30,20,18,9,3,11,34,32.4,23,403,118,29.3,130,151,122,39,7,0,32,16,46,24,0
Vicente Guaita,es ESP,GK,Crystal Palace,34,1987,29.5,0,0,0,0,0,0,0,,0,1,0,0,1,0,0,0,0,0,0,0,0,0,1
Marc Guéhi,eng ENG,DF,Crystal Palace,21,2000,35.8,33,22,23,9,1,11,17,64.7,6,223,91,40.8,142,70,11,46,29,0,17,57,90,139,0
Bruno Guimarães,br BRA,MF,Newcastle Utd,23,1997,11.5,51,39,26,21,4,14,32,43.8,18,299,89,29.8,108,144,47,27,7,0,20,19,70,9,0
İlkay Gündoğan,de GER,MF,Manchester City,30,1990,20.6,21,11,9,11,1,9,25,36,16,196,56,28.6,50,93,53,19,3,1,16,27,48,10,0
Angus Gunn,eng ENG,GK,Norwich City,25,1996,9,0,0,0,0,0,0,0,,0,2,0,0,2,0,0,0,0,0,0,0,0,1,0
Grant Hanley,sct SCO,DF,Norwich City,29,1991,32.2,55,38,38,14,3,14,29,48.3,15,269,102,37.9,192,67,10,77,54,1,23,65,120,196,1
Jack Harrison,eng ENG,FWMF,Leeds United,24,1996,29.3,56,32,20,23,13,26,60,43.3,34,600,168,28,170,254,176,53,3,0,50,41,97,30,0
Kortney Hause,eng ENG,DF,Aston Villa,26,1995,4.4,4,4,3,0,1,2,2,100,0,47,21,44.7,30,16,1,10,5,0,5,9,13,19,0
Kai Havertz,de GER,FWMF,Chelsea,22,1999,20.1,21,13,4,12,5,5,18,27.8,13,352,95,27,36,128,188,37,1,0,36,6,27,30,0
Isaac Hayden,eng ENG,MFDF,Newcastle Utd,26,1995,11.1,34,18,17,12,5,8,23,34.8,15,194,53,27.3,77,96,21,22,9,0,13,20,54,30,0
Hwang Hee-chan,kr KOR,FWMF,Wolves,25,1996,20.2,28,14,9,17,2,13,36,36.1,23,272,64,23.5,53,133,86,14,0,0,14,25,53,8,1
Jordan Henderson,eng ENG,MF,Liverpool,31,1990,28.9,37,24,7,26,4,16,47,34,31,467,146,31.3,99,257,111,31,3,0,28,43,80,17,0
Jeff Hendrick,ie IRL,MF,Newcastle Utd,29,1992,0.8,1,1,0,1,0,1,1,100,0,16,2,12.5,2,11,3,0,0,0,0,0,1,1,0
Wayne Hennessey,wls WAL,GK,Burnley,34,1987,2,0,0,0,0,0,0,0,,0,1,0,0,1,0,0,0,0,0,0,0,0,0,0
Rico Henry,eng ENG,DF,Brentford,24,1997,30.8,42,27,27,8,7,11,36,30.6,25,396,106,26.8,183,133,80,74,12,0,62,59,101,62,1
Son Heung-min,kr KOR,FWMF,Tottenham,29,1992,33.4,19,12,7,9,3,5,26,19.2,21,383,96,25.1,65,190,128,32,8,0,24,29,48,11,0
Ki-Jana Hoever,nl NED,DF,Wolves,19,2002,3.4,16,10,12,4,0,5,13,38.5,8,81,25,30.9,40,30,11,6,0,0,6,5,21,8,0
Pierre Højbjerg,dk DEN,MF,Tottenham,25,1995,35.5,84,49,28,45,11,29,80,36.3,51,669,176,26.3,255,319,95,73,13,0,60,70,154,61,0
Rob Holding,eng ENG,DF,Arsenal,25,1995,9.4,12,7,10,1,1,5,8,62.5,3,62,19,30.6,35,23,4,25,18,0,7,15,27,50,0
Mason Holgate,eng ENG,DF,Everton,24,1996,23.7,44,26,31,12,1,14,30,46.7,16,231,78,33.8,142,74,15,30,19,2,11,42,86,127,0
Callum Hudson-Odoi,eng ENG,FWMF,Chelsea,20,2000,10.7,13,6,4,7,2,3,15,20,12,158,38,24.1,24,77,57,13,0,0,13,5,18,5,0
Will Hughes,eng ENG,MF,Crystal Palace,26,1995,11.7,29,15,9,17,3,7,19,36.8,12,217,57,26.3,72,125,20,25,7,0,18,21,50,14,0
Adam Idah,ie IRL,FWMF,Norwich City,20,2001,6.9,11,6,4,5,2,2,5,40,3,93,23,24.7,15,40,38,4,3,0,1,4,15,8,0
Kelechi Iheanacho,ng NGA,FW,Leicester City,24,1996,14,15,9,2,9,4,4,12,33.3,8,244,65,26.6,17,111,116,16,1,0,15,4,19,10,0
Danny Ings,eng ENG,FW,Aston Villa,29,1992,21.1,26,11,6,14,6,11,28,39.3,17,385,89,23.1,52,165,168,30,4,0,26,15,41,19,0
Tim Iroegbunam,eng ENG,MF,Aston Villa,18,2003,1,5,2,3,2,0,1,2,50,1,24,8,33.3,6,16,2,1,0,0,1,2,7,1,0
Alex Iwobi,ng NGA,MFDF,Everton,25,1996,22.6,46,28,24,15,7,20,47,42.6,27,519,153,29.5,182,211,126,45,4,0,41,40,86,23,0
Daniel James,wls WAL,FWMF,Leeds United,23,1997,26.3,35,17,12,13,10,11,26,42.3,15,580,149,25.7,87,221,272,24,2,0,22,19,54,12,0
Daniel James,wls WAL,FW,Manchester Utd,23,1997,1.4,4,4,0,4,0,1,1,100,0,31,8,25.8,5,13,13,2,0,0,2,0,4,1,0
Reece James,eng ENG,DF,Chelsea,21,1999,20.7,39,23,22,14,3,8,25,32,17,265,93,35.1,98,107,60,29,3,1,26,21,60,21,0
Vitaly Janelt,de GER,MF,Brentford,23,1998,25.5,62,35,23,28,11,17,44,38.6,27,487,145,29.8,128,246,113,43,8,0,35,44,106,34,1
Pontus Jansson,se SWE,DF,Brentford,30,1991,36.9,36,25,27,8,1,17,36,47.2,19,204,75,36.8,120,71,13,56,27,0,29,69,105,208,2
Mathias Jensen,dk DEN,MF,Brentford,25,1996,17.8,34,28,12,17,5,19,61,31.1,42,456,133,29.2,166,214,76,33,4,0,29,33,67,14,1
Gabriel Jesus,br BRA,FW,Manchester City,24,1997,20.9,24,12,5,6,13,6,25,24,19,295,72,24.4,33,129,133,25,1,0,24,18,42,7,0
Raúl Jiménez,mx MEX,FW,Wolves,30,1991,29.2,33,23,4,18,11,4,21,19,17,445,108,24.3,41,234,170,36,8,1,28,19,52,27,0
João Pedro,br BRA,FWMF,Watford,19,2001,18.3,22,17,5,11,6,4,16,25,12,337,108,32,52,159,126,28,5,1,23,19,41,18,0
Joelinton,br BRA,MFFW,Newcastle Utd,24,1996,28.4,72,44,33,28,11,23,56,41.1,33,610,163,26.7,190,277,143,67,12,0,55,48,120,47,1
Ben Johnson,eng ENG,DF,West Ham,21,2000,15.5,30,16,14,12,4,17,30,56.7,13,172,61,35.5,87,53,32,49,10,1,39,25,55,49,0
Curtis Jones,eng ENG,MF,Liverpool,20,2001,9.5,12,9,3,8,1,2,9,22.2,7,212,61,28.8,37,116,59,5,0,0,5,10,22,2,0
Phil Jones,eng ENG,DF,Manchester Utd,29,1992,1.8,6,4,4,1,1,3,4,75,1,23,4,17.4,11,11,1,3,3,0,0,5,11,9,0
Mathias Jørgensen,dk DEN,DF,Brentford,31,1990,5.8,11,2,4,4,3,6,9,66.7,3,54,13,24.1,28,19,7,8,1,0,7,10,21,14,0
Jorginho,it ITA,MF,Chelsea,29,1991,25.3,68,46,30,32,6,23,76,30.3,53,488,175,35.9,176,237,75,35,6,0,29,60,128,21,1
Diogo Jota,pt POR,FW,Liverpool,24,1996,26.3,36,21,14,15,7,10,47,21.3,37,589,164,27.8,98,237,254,19,3,0,16,17,53,6,0
James Justin,eng ENG,DF,Leicester City,23,1998,11.1,31,21,14,12,5,9,18,50,9,181,52,28.7,86,72,23,28,5,0,23,27,58,33,0
Ozan Kabak,tr TUR,DF,Norwich City,21,2000,10.2,13,11,6,6,1,4,9,44.4,5,94,38,40.4,65,27,2,19,12,0,7,22,35,29,0
Christian Kabasele,be BEL,DF,Watford,30,1991,13.3,10,6,7,3,0,3,5,60,2,83,35,42.2,57,24,2,33,17,0,16,26,36,58,2
Samuel Kalu,ng NGA,FW,Watford,23,1997,2.5,2,2,0,2,0,1,2,50,1,23,6,26.1,7,6,10,3,0,0,3,5,7,3,0
Hassane Kamara,ci CIV,DF,Watford,27,1994,18,61,29,38,18,5,24,40,60,16,300,75,25,177,101,22,33,5,0,28,94,155,57,0
Harry Kane,eng ENG,FW,Tottenham,28,1993,35.9,19,10,3,11,5,8,25,32,17,378,110,29.1,27,150,201,22,9,1,13,7,26,38,0
N'Golo Kanté,fr FRA,MF,Chelsea,30,1991,19.7,57,34,22,22,13,19,38,50,19,385,134,34.8,123,180,82,37,2,0,35,44,101,14,0
Edo Kayembe,cd COD,MF,Watford,23,1998,8.9,21,15,10,9,2,5,10,50,5,127,47,37,63,59,5,13,1,0,12,14,35,20,0
Moise Kean,it ITA,FW,Everton,21,2000,0,0,0,0,0,0,0,0,,0,0,0,,0,0,0,0,0,0,0,0,0,0,0
Michael Keane,eng ENG,DF,Everton,28,1993,31,49,35,35,12,2,25,43,58.1,18,228,93,40.8,131,81,16,51,32,0,19,62,111,149,2
Naby Keïta,gn GUI,MF,Liverpool,26,1995,13,47,28,19,19,9,18,35,51.4,17,321,107,33.3,74,161,86,24,2,0,22,20,67,4,0
Caoimhín Kelleher,ie IRL,GK,Liverpool,22,1998,2,0,0,0,0,0,0,0,,0,0,0,,0,0,0,0,0,0,0,0,0,0,0
Kenedy,br BRA,DF,Chelsea,25,1996,0.6,3,2,0,1,2,0,2,0,2,9,2,22.2,1,5,3,2,0,0,2,0,3,0,0
Jonjoe Kenny,eng ENG,DF,Everton,24,1997,11.3,19,12,9,9,1,14,28,50,14,141,51,36.2,64,64,13,17,2,0,15,32,51,21,0
Max Kilman,eng ENG,DF,Wolves,24,1997,29.9,53,33,40,13,0,20,33,60.6,13,240,92,38.3,159,70,11,52,21,0,31,64,117,118,1
Joshua King,no NOR,FW,Watford,29,1992,25,31,21,6,17,8,5,16,31.3,11,486,134,27.6,69,221,196,21,5,0,16,12,43,27,0
Kristoffer Klaesson,no NOR,GK,Leeds United,20,2000,0.4,0,0,0,0,0,0,0,,0,0,0,,0,0,0,0,0,0,0,0,0,0,0
Mateusz Klich,pl POL,MF,Leeds United,31,1990,23,49,26,18,24,7,19,66,28.8,47,595,150,25.2,178,312,105,24,6,0,18,31,80,24,0
Robin Koch,de GER,MFDF,Leeds United,25,1996,17.5,31,20,15,11,5,12,36,33.3,24,299,100,33.4,135,131,33,33,11,1,22,34,65,46,0
Sead Kolašinac,ba BIH,DF,Arsenal,28,1993,1,1,1,1,0,0,0,0,,0,12,3,25,7,3,2,2,0,0,2,4,5,8,0
Ibrahima Konaté,fr FRA,DF,Liverpool,22,1999,11,14,8,6,7,1,3,7,42.9,4,86,23,26.7,44,36,6,15,10,1,5,28,42,47,0
Ezri Konsa,eng ENG,DF,Aston Villa,23,1997,27.5,26,14,15,10,1,7,13,53.8,6,179,64,35.8,106,60,13,43,22,0,21,45,71,81,2
Cheikhou Kouyaté,sn SEN,MF,Crystal Palace,31,1989,21.9,60,34,32,26,2,15,34,44.1,19,393,115,29.3,193,177,23,59,17,0,42,45,105,54,0
Mateo Kovačić,hr CRO,MF,Chelsea,27,1994,17.3,52,40,15,27,10,17,33,51.5,16,379,115,30.3,97,214,68,18,4,0,14,20,72,13,1
Emil Krafth,se SWE,DF,Newcastle Utd,26,1994,18.2,39,20,29,9,1,21,39,53.8,18,232,64,27.6,112,95,25,38,10,0,28,48,87,53,0
Alex Král,cz CZE,MF,West Ham,23,1998,0,0,0,0,0,0,0,0,,0,2,2,100,0,1,1,0,0,0,0,0,0,0,0
Tim Krul,nl NED,GK,Norwich City,33,1988,29,0,0,0,0,0,0,3,0,3,9,2,22.2,9,0,0,1,0,0,1,0,0,0,4
Juraj Kucka,sk SVK,MF,Watford,34,1987,21.3,74,47,41,27,6,28,67,41.8,39,423,135,31.9,157,201,65,39,9,1,30,46,120,50,1
Dejan Kulusevski,se SWE,MFFW,Tottenham,21,2000,14,20,16,9,10,1,6,19,31.6,13,310,79,25.5,112,126,72,11,0,0,11,26,46,1,0
Alexandre Lacazette,fr FRA,FWMF,Arsenal,30,1991,19.8,26,19,7,13,6,7,15,46.7,8,358,108,30.2,47,126,185,13,2,0,11,13,39,6,0
Adam Lallana,eng ENG,MF,Brighton,33,1988,17.3,38,22,19,15,4,11,36,30.6,25,304,105,34.5,113,133,58,26,8,0,18,27,65,15,0
Tariq Lamptey,eng ENG,DFFW,Brighton,20,2000,17.3,38,23,15,18,5,14,26,53.8,12,245,74,30.2,78,96,71,22,4,0,18,37,75,19,0
Manuel Lanzini,ar ARG,MFFW,West Ham,28,1993,19.8,25,18,11,8,6,12,41,29.3,29,373,95,25.5,107,192,74,22,1,0,21,28,53,7,0
Aymeric Laporte,es ESP,DF,Manchester City,27,1994,31.4,31,17,20,10,1,15,25,60,10,139,63,45.3,81,50,8,24,11,0,13,33,64,78,2
Jamaal Lascelles,eng ENG,DF,Newcastle Utd,27,1993,22.9,21,11,16,3,2,7,18,38.9,11,154,51,33.1,94,53,7,50,32,1,18,35,56,134,0
Pierre Lees-Melou,fr FRA,MF,Norwich City,28,1993,25.2,65,40,29,26,10,24,82,29.3,58,650,162,24.9,249,307,94,41,12,2,29,42,107,20,0
Aaron Lennon,eng ENG,MF,Burnley,34,1987,17.2,38,18,13,16,9,9,39,23.1,30,348,83,23.9,97,142,109,32,4,0,28,15,53,13,0
Bernd Leno,de GER,GK,Arsenal,29,1992,4,0,0,0,0,0,0,0,,0,0,0,,0,0,0,0,0,0,0,0,0,0,0
Jamal Lewis,nir NIR,DF,Newcastle Utd,23,1998,2.9,11,6,7,2,2,3,4,75,1,42,14,33.3,25,8,9,5,2,0,3,6,17,6,0
Victor Lindelöf,se SWE,DF,Manchester Utd,27,1994,26.2,19,10,9,9,1,9,16,56.3,7,155,58,37.4,75,73,7,42,20,0,22,51,70,120,1
Jesse Lingard,eng ENG,FWMF,Manchester Utd,28,1992,4.1,11,6,3,6,2,2,3,66.7,1,110,28,25.5,20,45,45,3,0,0,3,4,15,1,0
Valentino Livramento,eng ENG,DF,Southampton,18,2002,24.5,54,30,32,17,5,25,45,55.6,20,332,110,33.1,164,125,43,45,10,0,35,73,127,49,0
Diego Llorente,es ESP,DF,Leeds United,27,1993,26,56,35,38,16,2,30,53,56.6,23,361,140,38.8,208,140,13,61,19,0,42,61,117,105,1
Hugo Lloris,fr FRA,GK,Tottenham,34,1986,38,0,0,0,0,0,0,1,0,1,4,1,25,3,1,0,0,0,0,0,0,0,0,3
Giovani Lo Celso,ar ARG,MFFW,Tottenham,25,1996,2.6,8,3,4,3,1,3,12,25,9,69,14,20.3,26,29,14,7,1,0,6,3,11,0,0
Jürgen Locadia,nl NED,FW,Brighton,27,1993,0.3,1,1,0,1,0,0,0,,0,4,3,75,0,2,2,0,0,0,0,0,1,0,0
Ruben Loftus-Cheek,eng ENG,MFDF,Chelsea,25,1996,15.5,31,20,17,10,4,5,16,31.3,11,251,84,33.5,81,124,46,21,6,0,15,15,46,22,0
Kevin Long,ie IRL,DF,Burnley,30,1990,4.6,6,5,3,3,0,0,2,0,2,42,13,31,22,16,4,8,3,0,5,7,13,15,0
Shane Long,ie IRL,FW,Southampton,34,1987,3.4,8,3,2,4,2,1,1,100,0,83,24,28.9,10,32,41,3,0,0,3,1,9,1,0
Sean Longstaff,eng ENG,MF,Newcastle Utd,23,1997,16.3,51,33,20,24,7,19,62,30.6,43,427,108,25.3,158,209,60,27,6,0,21,20,71,22,0
Ademola Lookman,ng NGA,FWMF,Leicester City,23,1997,16.1,41,25,14,20,7,9,26,34.6,17,345,98,28.4,81,163,101,26,1,0,25,20,61,2,0
Jonas Lössl,dk DEN,GK,Brentford,32,1989,2,0,0,0,0,0,0,0,,0,0,0,,0,0,0,0,0,0,0,0,0,0,0
Imran Louza,ma MAR,MF,Watford,22,1999,15.7,51,32,25,21,5,20,44,45.5,24,345,105,30.4,143,159,43,23,6,0,17,48,99,22,0
Matthew Lowton,eng ENG,DF,Burnley,32,1989,19.7,45,26,21,17,7,21,46,45.7,25,188,61,32.4,74,70,44,45,13,0,32,34,79,68,0
Douglas Luiz,br BRA,MF,Aston Villa,23,1998,30.2,64,43,35,24,5,24,73,32.9,49,524,156,29.8,229,243,52,44,8,0,36,61,125,29,0
Romelu Lukaku,be BEL,FW,Chelsea,28,1993,17.7,5,3,0,2,3,2,5,40,3,190,55,28.9,6,63,121,10,3,0,7,1,6,21,0
Lyanco,br BRA,DF,Southampton,24,1997,10.1,17,14,11,6,0,5,14,35.7,9,99,43,43.4,54,44,1,28,17,0,11,29,46,66,1
Alexis Mac Allister,ar ARG,MFFW,Brighton,22,1998,23.6,73,51,27,31,15,22,59,37.3,37,566,199,35.2,163,258,145,45,7,0,38,23,96,20,0
James Maddison,eng ENG,MFFW,Leicester City,24,1996,27.3,45,24,10,25,10,8,31,25.8,23,498,114,22.9,116,251,131,27,3,0,24,20,65,10,0
Harry Maguire,eng ENG,DF,Manchester Utd,28,1993,27.9,41,26,25,11,5,14,27,51.9,13,173,65,37.6,118,49,6,46,32,0,14,53,94,130,0
Riyad Mahrez,dz ALG,FW,Manchester City,30,1991,16.6,10,6,4,2,4,3,15,20,12,192,58,30.2,33,80,79,16,1,0,15,13,23,2,0
Ainsley Maitland-Niles,eng ENG,MF,Arsenal,23,1997,3,7,4,4,2,1,1,4,25,3,54,17,31.5,19,25,10,5,1,0,4,3,10,4,0
Sadio Mané,sn SEN,FW,Liverpool,29,1992,31.3,33,18,7,13,13,8,25,32,17,452,143,31.6,57,193,202,36,4,0,32,15,48,10,0
Javier Manquillo,es ESP,DF,Newcastle Utd,27,1994,14,41,24,27,10,4,19,36,52.8,17,175,56,32,100,46,29,28,6,0,22,23,64,29,0
Fernando Marçal,br BRA,DF,Wolves,32,1989,16.1,42,26,29,10,3,17,33,51.5,16,241,67,27.8,127,83,31,42,5,0,37,31,73,54,0
Solly March,eng ENG,DFFW,Brighton,27,1994,19.4,38,22,15,9,14,9,24,37.5,15,260,72,27.7,71,82,107,33,4,0,29,31,69,23,0
Pablo Marí,es ESP,DF,Arsenal,27,1993,2,6,2,2,3,1,4,8,50,4,19,4,21.1,9,8,2,6,4,0,2,6,12,11,0
Anthony Martial,fr FRA,FW,Manchester Utd,25,1995,2.4,1,1,0,0,1,0,1,0,1,28,11,39.3,6,9,13,3,0,0,3,1,2,2,0
Martinelli,br BRA,FWMF,Arsenal,20,2001,20.7,30,19,10,14,6,6,21,28.6,15,341,99,29,58,113,170,41,6,0,35,21,51,15,0
Emiliano Martínez,ar ARG,GK,Aston Villa,28,1992,36,0,0,0,0,0,0,2,0,2,2,0,0,2,0,0,0,0,0,0,1,1,1,1
Adam Masina,ma MAR,DF,Watford,27,1994,12,24,14,11,12,1,10,30,33.3,20,162,45,27.8,73,70,19,29,6,0,23,31,55,41,0
Arthur Masuaku,cd COD,DFFW,West Ham,27,1993,7.2,33,19,20,11,2,12,23,52.2,11,120,39,32.5,61,50,9,10,1,0,9,18,51,16,0
Juan Mata,es ESP,MF,Manchester Utd,33,1988,2.6,7,6,2,4,1,3,5,60,2,51,15,29.4,17,24,10,1,0,0,1,2,9,2,0
Jean-Philippe Mateta,fr FRA,FW,Crystal Palace,24,1997,12.7,7,5,1,5,1,3,13,23.1,10,250,51,20.4,22,138,90,12,3,0,9,4,11,15,0
Nemanja Matić,rs SRB,MF,Manchester Utd,32,1988,15.4,34,28,20,13,1,10,29,34.5,19,232,70,30.2,106,107,19,34,6,0,28,32,66,31,1
Joël Matip,cm CMR,DF,Liverpool,29,1991,31,48,36,24,18,6,17,29,58.6,12,210,89,42.4,117,74,19,38,17,1,21,66,114,121,1
Neal Maupay,fr FRA,FW,Brighton,24,1996,25.3,19,12,3,9,7,5,14,35.7,9,508,143,28.1,43,186,279,21,3,0,18,10,29,3,0
Bryan Mbeumo,fr FRA,FW,Brentford,21,1999,32.3,38,25,3,18,17,7,18,38.9,11,505,138,27.3,74,222,209,38,8,0,30,23,61,21,0
James McArthur,sct SCO,MF,Crystal Palace,33,1987,16,37,26,18,17,2,15,40,37.5,25,376,129,34.3,130,197,49,34,9,0,25,34,71,42,0
James Mcatee,eng ENG,MFFW,Manchester City,18,2002,0.2,0,0,0,0,0,0,2,0,2,9,2,22.2,2,0,7,0,0,0,0,1,1,0,0
Kasey McAteer,eng ENG,FW,Leicester City,19,2001,0,0,0,0,0,0,0,0,,0,4,1,25,0,2,2,0,0,0,0,0,0,0,0
Liam McCarron,sct SCO,FW,Leeds United,20,2001,0.1,0,0,0,0,0,0,0,,0,3,0,0,2,0,1,0,0,0,0,0,0,0,0
Alex McCarthy,eng ENG,GK,Southampton,31,1989,17,0,0,0,0,0,0,0,,0,0,0,,0,0,0,0,0,0,0,0,0,0,0
John McGinn,sct SCO,MF,Aston Villa,26,1994,34.3,104,61,39,51,14,42,104,40.4,62,560,174,31.1,162,298,100,61,7,0,54,52,156,38,0
Stuart McKinstry,sct SCO,MF,Leeds United,18,2002,0,0,0,0,0,0,0,0,,0,1,1,100,1,0,0,0,0,0,0,0,0,0,0
Kenny McLean,sct SCO,MF,Norwich City,29,1992,30.1,41,24,15,23,3,17,60,28.3,43,516,115,22.3,210,232,74,32,7,0,25,55,96,55,0
Dwight McNeil,eng ENG,MF,Burnley,21,1999,34.5,68,36,28,32,8,22,74,29.7,52,680,172,25.3,237,288,155,82,12,2,70,67,135,20,0
Scott McTominay,sct SCO,MF,Manchester Utd,24,1996,26.5,69,33,38,24,7,33,66,50,33,490,132,26.9,182,246,62,48,11,0,37,47,116,65,0
Ben Mee,eng ENG,DF,Burnley,31,1989,20.4,27,16,15,9,3,11,22,50,11,109,39,35.8,61,42,6,40,26,1,14,35,62,122,0
Hannibal Mejbri,tn TUN,FW,Manchester Utd,18,2003,0.8,0,0,0,0,0,0,0,,0,32,6,18.8,6,13,13,0,0,0,0,1,1,0,0
Benjamin Mendy,fr FRA,DF,Manchester City,27,1994,0.9,3,1,1,1,1,2,4,50,2,12,2,16.7,3,8,1,0,0,0,0,0,3,3,0
Edouard Mendy,sn SEN,GK,Chelsea,29,1992,34,0,0,0,0,0,0,2,0,2,3,1,33.3,3,0,0,0,0,0,0,0,0,1,5
Nampalys Mendy,sn SEN,MF,Leicester City,29,1992,11.5,16,12,9,6,1,6,16,37.5,10,155,56,36.1,65,74,16,16,4,0,12,13,29,9,1
Illan Meslier,fr FRA,GK,Leeds United,21,2000,37.6,0,0,0,0,0,0,0,,0,5,2,40,5,0,0,0,0,0,0,0,0,2,2
Luka Milivojević,rs SRB,MF,Crystal Palace,30,1991,8.6,21,13,10,9,2,13,22,59.1,9,137,45,32.8,56,67,14,9,1,0,8,9,30,23,0
James Milner,eng ENG,MFDF,Liverpool,35,1986,9.5,35,23,15,15,5,15,35,42.9,20,172,68,39.5,37,93,42,20,6,0,14,22,57,22,0
Yerry Mina,co COL,DF,Everton,26,1994,9.4,17,12,17,0,0,9,14,64.3,5,70,30,42.9,48,19,3,19,11,1,8,10,27,47,1
Takumi Minamino,jp JPN,FWMF,Liverpool,26,1995,2.1,3,2,1,1,1,2,11,18.2,9,64,22,34.4,4,34,26,1,0,0,1,3,6,1,0
Tyrone Mings,eng ENG,DF,Aston Villa,28,1993,35.4,36,21,23,8,5,11,21,52.4,10,203,66,32.5,113,67,23,70,34,3,36,78,114,181,2
Tyrick Mitchell,eng ENG,DF,Crystal Palace,21,1999,34.5,107,54,73,24,10,42,64,65.6,22,683,217,31.8,394,189,100,77,6,0,71,80,187,85,1
Jakub Moder,pl POL,MFFW,Brighton,22,1999,18.9,42,29,19,14,9,18,40,45,22,361,116,32.1,118,135,108,31,2,0,29,22,64,26,1
Wesley Moraes,br BRA,FW,Aston Villa,24,1996,0,0,0,0,0,0,0,0,,0,2,1,50,1,0,1,0,0,0,0,0,0,0,0
Tyler Morton,eng ENG,MF,Liverpool,18,2002,0.7,0,0,0,0,0,0,2,0,2,12,4,33.3,1,9,2,0,0,0,0,2,2,0,0
Mason Mount,eng ENG,MFFW,Chelsea,22,1999,26.3,43,29,10,18,15,11,33,33.3,22,528,161,30.5,86,208,234,23,2,0,21,20,63,11,0
Lucas Moura,br BRA,FWMF,Tottenham,28,1992,19.7,29,14,6,16,7,6,26,23.1,20,278,68,24.5,66,140,72,18,1,0,17,22,51,21,0
João Moutinho,pt POR,MF,Wolves,34,1986,33,76,54,37,29,10,27,98,27.6,71,608,186,30.6,232,318,58,52,8,0,44,48,124,35,0
Bali Mumba,eng ENG,DF,Norwich City,19,2001,0.5,1,0,1,0,0,0,0,,0,12,3,25,10,2,0,2,0,0,2,1,2,5,0
Jacob Murphy,eng ENG,FWDF,Newcastle Utd,26,1995,16.4,41,17,27,11,3,15,35,42.9,20,320,71,22.2,136,106,78,31,2,0,29,33,74,20,0
Enock Mwepu,zm ZAM,MFFW,Brighton,23,1998,11.1,25,14,8,12,5,7,29,24.1,22,223,57,25.6,63,93,67,24,4,0,20,16,41,19,0
Vitaliy Mykolenko,ua UKR,DF,Everton,22,1999,11.7,28,14,16,9,3,12,26,46.2,14,172,43,25,88,58,26,34,2,0,32,25,53,31,1
Marvelous Nakamba,zw ZIM,MF,Aston Villa,27,1994,10,31,19,19,11,1,14,35,40,21,209,59,28.2,107,86,16,16,4,0,12,23,54,16,0
Wilfred Ndidi,ng NGA,MFDF,Leicester City,24,1996,18,70,47,39,28,3,21,47,44.7,26,410,137,33.4,155,214,41,32,6,0,26,45,115,69,0
Tanguy Ndombele,fr FRA,MF,Tottenham,24,1996,5.4,13,10,4,8,1,1,6,16.7,5,88,26,29.5,24,45,19,2,1,0,1,3,16,3,0
Reiss Nelson,eng ENG,FW,Arsenal,21,1999,0.2,1,0,0,1,0,0,0,,0,8,2,25,2,5,1,0,0,0,0,1,2,0,0
Pedro Neto,pt POR,FWMF,Wolves,21,2000,5.2,5,5,2,2,1,0,7,0,7,90,22,24.4,18,38,34,1,0,0,1,6,11,1,0
Rúben Neves,pt POR,MF,Wolves,24,1997,29.6,67,43,32,29,6,22,90,24.4,68,541,145,26.8,203,288,50,43,6,0,37,55,122,54,1
Jeremy Ngakia,eng ENG,DF,Watford,20,2000,10,41,21,34,4,3,20,33,60.6,13,202,55,27.2,139,48,15,16,3,0,13,29,70,20,0
Saúl Ñíguez,es ESP,MFDF,Chelsea,26,1994,5.3,15,8,7,6,2,6,15,40,9,103,29,28.2,43,48,12,13,3,0,10,14,29,7,1
Eddie Nketiah,eng ENG,FW,Arsenal,22,1999,9.3,12,7,0,7,5,1,3,33.3,2,178,50,28.1,11,62,105,7,2,0,5,6,18,7,0
Nicolas Nkoulou,cm CMR,DF,Watford,31,1990,1.9,1,0,0,1,0,0,0,,0,7,5,71.4,5,2,0,5,2,0,3,1,2,10,0
Mark Noble,eng ENG,MF,West Ham,34,1987,3.7,11,7,9,2,0,2,4,50,2,53,21,39.6,23,23,7,4,1,0,3,5,16,3,0
Christian Nørgaard,dk DEN,MF,Brentford,27,1994,33.9,130,80,54,64,12,54,105,51.4,51,691,218,31.5,260,366,65,59,10,1,49,85,215,57,1
Mathias Normann,no NOR,MF,Norwich City,25,1996,18.3,38,24,21,14,3,11,35,31.4,24,324,66,20.4,144,156,24,26,11,1,15,25,63,43,0
Martin Ødegaard,no NOR,MF,Arsenal,22,1998,30.9,43,25,5,19,19,12,39,30.8,27,574,154,26.8,107,262,205,18,1,0,17,22,65,12,1
Angelo Ogbonna,it ITA,DF,West Ham,33,1988,10.2,13,8,8,5,0,2,7,28.6,5,50,16,32,32,15,3,7,4,0,3,13,26,38,0
Michael Olise,fr FRA,FWMF,Crystal Palace,19,2001,12.7,22,15,9,8,5,9,20,45,11,248,69,27.8,72,118,58,23,0,0,23,12,34,9,0
Robin Olsen,se SWE,GK,Aston Villa,31,1990,1,0,0,0,0,0,0,0,,0,0,0,,0,0,0,0,0,0,0,0,0,0,0
Andrew Omobamidele,ie IRL,DF,Norwich City,19,2002,4.2,8,3,5,3,0,6,12,50,6,49,14,28.6,37,12,0,10,10,0,0,10,18,17,0
Tyler Onyango,eng ENG,MFFW,Everton,18,2003,0.3,1,0,1,0,0,0,1,0,1,10,2,20,6,3,1,0,0,0,0,1,2,0,0
Frank Onyeka,ng NGA,MF,Brentford,23,1998,11.6,30,16,14,12,4,5,20,25,15,253,69,27.3,109,106,38,20,2,0,18,15,45,13,0
Divock Origi,be BEL,FW,Liverpool,26,1995,1.5,0,0,0,0,0,0,3,0,3,29,5,17.2,2,16,11,2,0,0,2,3,3,1,0
Alex Oxlade-Chamberlain,eng ENG,MFFW,Liverpool,27,1993,8.7,17,14,3,7,7,5,13,38.5,8,172,63,36.6,26,76,70,11,3,0,8,8,25,7,0
Cole Palmer,eng ENG,FWMF,Manchester City,19,2002,1.4,2,2,1,1,0,0,1,0,1,29,6,20.7,3,11,15,2,0,0,2,2,4,0,0
Emerson Palmieri,it ITA,DF,Chelsea,26,1994,0.1,0,0,0,0,0,0,0,,0,0,0,,0,0,0,0,0,0,0,0,0,0,0
Thomas Partey,gh GHA,MF,Arsenal,28,1993,22.5,55,41,25,23,7,18,41,43.9,23,291,103,35.4,107,148,36,28,5,0,23,33,88,32,1
Nicolas Pépé,ci CIV,FWMF,Arsenal,26,1995,7.7,14,11,7,5,2,2,9,22.2,7,122,35,28.7,36,45,41,13,1,0,12,9,23,3,1
Ricardo Pereira,pt POR,DF,Leicester City,27,1993,11,45,25,24,15,6,20,39,51.3,19,194,62,32,76,81,37,27,4,0,23,25,70,32,0
Ayoze Pérez,es ESP,MFFW,Leicester City,28,1993,4.9,8,6,2,5,1,2,11,18.2,9,128,33,25.8,31,62,35,11,2,0,9,9,17,3,0
Sonny Perkins,eng ENG,FW,West Ham,17,2004,0,0,0,0,0,0,0,0,,0,1,1,100,0,1,0,0,0,0,0,0,0,0,0
Romain Perraud,fr FRA,DF,Southampton,23,1997,18,38,20,19,14,5,16,28,57.1,12,325,85,26.2,146,108,71,30,7,1,23,24,62,46,0
Kalvin Phillips,eng ENG,MF,Leeds United,25,1995,17.7,64,42,27,32,5,18,48,37.5,30,504,149,29.6,163,261,80,42,10,0,32,34,98,30,1
Jaden Philogene Bidace,eng ENG,FW,Aston Villa,19,2002,0.1,0,0,0,0,0,0,0,,0,2,0,0,1,1,0,0,0,0,0,0,0,0,0
Jordan Pickford,eng ENG,GK,Everton,27,1994,35,1,0,1,0,0,0,1,0,1,7,1,14.3,7,0,0,2,0,0,2,0,1,1,0
Erik Pieters,nl NED,DF,Burnley,32,1988,8.1,28,16,22,5,1,16,35,45.7,19,143,40,28,75,53,15,25,7,0,18,23,51,27,1
Ethan Pinnock,jm JAM,DF,Brentford,28,1993,29.9,63,38,46,15,2,20,36,55.6,16,281,102,36.3,167,94,20,49,13,0,36,56,119,175,1
Przemysław Płacheta,pl POL,FWMF,Norwich City,23,1998,5.6,5,3,5,0,0,0,4,0,4,115,25,21.7,34,55,26,7,1,0,6,9,14,5,0
Daniel Podence,pt POR,FWMF,Wolves,25,1995,16.5,19,9,9,6,4,8,21,38.1,13,247,67,27.1,49,101,97,13,2,0,11,6,25,0,0
Paul Pogba,fr FRA,MFFW,Manchester Utd,28,1993,15,20,13,9,9,2,5,19,26.3,14,264,76,28.8,61,127,76,16,1,0,15,19,39,25,0
Nick Pope,eng ENG,GK,Burnley,29,1992,36,0,0,0,0,0,0,2,0,2,1,1,100,1,0,0,0,0,0,0,0,0,4,2
Isaac Price,nir NIR,MF,Everton,17,2003,0.2,1,0,0,1,0,1,1,100,0,8,1,12.5,4,3,1,1,0,0,1,1,2,0,0
Teemu Pukki,fi FIN,FW,Norwich City,31,1990,36.1,24,11,1,14,9,3,16,18.8,13,702,175,24.9,40,289,373,21,2,0,19,17,41,4,0
Christian Pulisic,us USA,MFFW,Chelsea,22,1998,14.3,18,9,5,11,2,2,12,16.7,10,294,72,24.5,47,124,123,18,0,0,18,11,29,9,0
Jesuran Rak Sakyi,eng ENG,FWMF,Crystal Palace,18,2002,0.9,0,0,0,0,0,0,1,0,1,20,2,10,3,9,8,2,0,0,2,3,3,0,0
Aaron Ramsdale,eng ENG,GK,Arsenal,23,1998,34,0,0,0,0,0,0,3,0,3,3,0,0,3,0,0,0,0,0,0,0,0,2,0
Jacob Ramsey,eng ENG,MF,Aston Villa,20,2001,27.4,66,41,35,27,4,22,59,37.3,37,547,148,27.1,186,258,103,41,7,0,34,38,104,27,0
Raphinha,br BRA,FWMF,Leeds United,24,1996,32.4,54,25,24,19,11,18,69,26.1,51,574,136,23.7,142,239,193,59,2,0,57,43,97,23,0
Marcus Rashford,eng ENG,FWMF,Manchester Utd,23,1997,13.7,8,6,2,5,1,3,17,17.6,14,254,76,29.9,41,115,98,11,1,0,10,12,20,6,1
Milot Rashica,xk KVX,FWMF,Norwich City,25,1996,24.8,33,21,15,13,5,14,34,41.2,20,328,93,28.4,114,111,103,27,3,0,24,36,69,20,0
David Raya,es ESP,GK,Brentford,25,1995,24,0,0,0,0,0,0,1,0,1,1,0,0,1,0,0,1,0,0,1,0,0,0,1
Nathan Redmond,eng ENG,MFFW,Southampton,27,1994,20.4,20,13,6,10,4,5,22,22.7,17,364,100,27.5,90,144,130,34,2,0,32,21,41,18,0
Sergio Reguilón,es ESP,DF,Tottenham,24,1996,21.3,47,28,22,19,6,23,39,59,16,298,89,29.9,117,131,50,32,7,0,25,42,89,43,0
Declan Rice,eng ENG,MF,West Ham,22,1999,35.3,77,53,44,29,4,28,60,46.7,32,476,154,32.4,215,224,37,60,25,1,35,95,172,53,1
Taylor Richards,eng ENG,MFFW,Brighton,20,2000,0.3,0,0,0,0,0,0,2,0,2,10,5,50,5,5,0,0,0,0,0,0,0,0,0
Richarlison,br BRA,FWMF,Everton,24,1997,28,40,27,14,14,12,13,25,52,12,590,144,24.4,89,237,264,48,5,0,43,21,61,32,0
Jaïro Riedewald,nl NED,MF,Crystal Palace,24,1996,1.3,2,2,0,1,1,2,4,50,2,11,3,27.3,7,2,2,4,0,0,4,0,2,2,0
Matt Ritchie,sct SCO,DF,Newcastle Utd,31,1989,14.9,22,7,11,8,3,13,30,43.3,17,153,47,30.7,76,55,22,28,2,0,26,30,52,26,0
Connor Roberts,wls WAL,DF,Burnley,25,1995,18.8,21,13,11,7,3,8,16,50,8,157,46,29.3,72,62,23,49,8,0,41,42,63,55,1
Tyler Roberts,wls WAL,MFFW,Leeds United,22,1999,11,17,7,7,6,4,9,15,60,6,169,44,26,24,85,60,10,1,0,9,7,24,8,0
Andrew Robertson,sct SCO,DF,Liverpool,27,1994,28.2,33,17,14,14,5,14,34,41.2,20,284,86,30.3,85,115,84,43,4,1,39,49,82,58,0
Joe Rodon,wls WAL,DF,Tottenham,23,1997,1,0,0,0,0,0,0,0,,0,7,3,42.9,5,2,0,3,2,0,1,2,2,8,0
Rodri,es ESP,MF,Manchester City,25,1996,32,65,46,20,36,9,29,61,47.5,32,481,171,35.6,130,254,97,48,6,1,42,40,105,54,0
Rodrigo,es ESP,MFFW,Leeds United,30,1991,25.2,26,18,5,12,9,9,26,34.6,17,417,118,28.3,66,183,168,15,1,0,14,19,45,27,0
Jay Rodriguez,eng ENG,FW,Burnley,32,1989,15.4,22,10,9,8,5,3,15,20,12,330,70,21.2,74,114,142,25,3,0,22,6,28,12,0
Mads Roerslev,dk DEN,DF,Brentford,22,1999,13.8,26,9,23,1,2,16,35,45.7,19,173,43,24.9,114,40,19,31,6,0,25,21,47,30,0
Cristian Romero,ar ARG,DF,Tottenham,23,1998,20.5,75,45,43,30,2,25,43,58.1,18,317,113,35.6,195,98,24,50,23,0,27,57,132,78,1
Oriol Romeu,es ESP,MF,Southampton,29,1991,32.1,81,54,23,47,11,23,77,29.9,54,564,191,33.9,181,309,74,45,9,0,36,67,148,52,0
Cristiano Ronaldo,pt POR,FW,Manchester Utd,36,1985,27.3,10,8,2,5,3,4,7,57.1,3,182,49,26.9,23,77,82,12,2,0,10,5,15,31,1
Salomón Rondón,ve VEN,FW,Everton,31,1989,8.8,6,2,0,3,3,3,10,30,7,172,50,29.1,17,75,80,6,1,0,5,4,10,11,0
Danny Rose,eng ENG,DF,Watford,31,1990,7.7,23,15,15,8,0,12,29,41.4,17,85,34,40,44,36,5,14,6,0,8,15,38,13,0
Jon Rowe,eng ENG,FWMF,Norwich City,18,2003,2.5,7,3,3,3,1,1,1,100,0,67,16,23.9,15,28,24,7,0,0,7,4,11,0,0
John Ruddy,eng ENG,GK,Wolves,34,1986,1.5,0,0,0,0,0,0,0,,0,0,0,,0,0,0,0,0,0,0,0,0,0,0
Antonio Rüdiger,de GER,DF,Chelsea,28,1993,33.7,53,28,30,21,2,30,46,65.2,16,294,92,31.3,146,115,33,41,13,0,28,43,96,110,1
Lukas Rupp,de GER,MF,Norwich City,30,1991,8.5,10,8,5,5,0,4,14,28.6,10,172,53,30.8,75,73,24,8,1,0,7,17,27,4,1
José Sá,pt POR,GK,Wolves,28,1993,36.5,1,0,1,0,0,1,3,33.3,2,10,3,30,10,0,0,1,0,0,1,0,1,3,3
Allan Saint-Maximin,fr FRA,FWMF,Newcastle Utd,24,1997,31.2,9,6,4,2,3,2,18,11.1,16,256,67,26.2,52,109,95,17,1,0,16,21,30,2,0
Romain Saïss,ma MAR,DF,Wolves,31,1990,30.1,60,38,40,17,3,18,32,56.3,14,283,103,36.4,162,101,20,61,24,0,37,81,141,173,1
Bukayo Saka,eng ENG,FWMF,Arsenal,19,2001,33.1,37,23,13,14,10,7,31,22.6,24,496,134,27,110,188,198,41,2,0,39,31,68,19,0
Mohamed Salah,eg EGY,FW,Liverpool,29,1992,30.7,17,7,5,7,5,4,21,19,17,448,127,28.3,67,127,254,13,1,0,12,15,32,4,0
Mohammed Salisu,gh GHA,DF,Southampton,22,1999,33,91,60,63,25,3,41,72,56.9,31,364,148,40.7,218,123,23,69,28,1,41,93,184,196,5
Albert Sambi Lokonga,be BEL,MF,Arsenal,21,1999,12.6,22,13,9,10,3,9,15,60,6,138,47,34.1,45,64,29,18,8,0,10,23,45,18,2
Davinson Sánchez,co COL,DF,Tottenham,25,1996,18.1,45,22,24,17,4,16,27,59.3,11,186,66,35.5,89,80,17,35,19,0,16,34,79,76,0
Robert Sánchez,es ESP,GK,Brighton,23,1997,37,0,0,0,0,0,0,0,,0,5,1,20,5,0,0,2,0,0,2,0,0,0,4
Jadon Sancho,eng ENG,FWMF,Manchester Utd,21,2000,21.1,18,13,8,8,2,7,23,30.4,16,276,68,24.6,65,128,83,28,2,0,26,24,42,5,2
Morgan Sanson,fr FRA,MF,Aston Villa,26,1994,4,12,8,5,4,3,4,6,66.7,2,135,46,34.1,51,60,24,15,0,0,15,11,23,2,0
Samir Santos,br BRA,DF,Watford,26,1994,18.6,32,19,21,10,1,10,17,58.8,7,143,53,37.1,98,38,7,28,11,1,17,54,86,82,2
Josh Sargent,us USA,FWMF,Norwich City,21,2000,17.5,34,17,16,8,10,13,32,40.6,19,361,100,27.7,97,143,121,43,2,0,41,21,55,18,2
Jeremy Sarmiento,ec ECU,FWMF,Brighton,19,2002,0.5,3,1,1,1,1,1,2,50,1,26,7,26.9,8,13,5,3,1,0,2,1,4,0,0
Ismaila Sarr,sn SEN,FWMF,Watford,23,1998,20.7,14,7,4,7,3,2,14,14.3,12,398,91,22.9,86,174,138,21,1,0,20,16,30,13,0
Malang Sarr,fr FRA,DF,Chelsea,22,1999,6.1,13,4,10,2,1,3,7,42.9,4,68,23,33.8,40,22,6,9,3,0,6,12,25,26,0
Dane Scarlett,eng ENG,MF,Tottenham,17,2004,0,0,0,0,0,0,0,0,,0,2,0,0,2,0,0,0,0,0,0,0,0,0,0
Fabian Schär,ch SUI,DF,Newcastle Utd,29,1991,24,20,11,14,4,2,11,16,68.8,5,151,47,31.1,82,52,17,37,19,2,18,75,95,121,2
Jeffrey Schlupp,gh GHA,MFFW,Crystal Palace,28,1992,20.6,50,23,19,23,8,15,41,36.6,26,384,122,31.8,112,196,76,51,10,0,41,25,75,33,0
Kasper Schmeichel,dk DEN,GK,Leicester City,34,1986,37,0,0,0,0,0,0,2,0,2,2,0,0,2,0,0,0,0,0,0,0,0,1,2
Ken Sema,se SWE,MFFW,Watford,27,1993,9.5,12,8,10,2,0,5,20,25,15,194,43,22.2,71,96,27,15,1,0,14,9,21,18,0
Nélson Semedo,pt POR,DF,Wolves,27,1993,23.7,59,40,40,15,4,26,48,54.2,22,379,108,28.5,182,130,67,43,4,0,39,43,102,57,0
Ryan Sessegnon,eng ENG,DF,Tottenham,21,2000,11.6,27,14,13,9,5,12,26,46.2,14,230,57,24.8,100,74,56,30,3,0,27,19,46,22,0
Jamie Shackleton,eng ENG,DFMF,Leeds United,21,1999,7.9,26,18,17,7,2,9,21,42.9,12,115,39,33.9,52,49,14,16,7,1,9,10,36,9,2
Luke Shaw,eng ENG,DF,Manchester Utd,26,1995,17.8,22,13,9,10,3,12,24,50,12,190,55,28.9,83,72,35,40,11,0,29,15,37,22,0
Jonjo Shelvey,eng ENG,MF,Newcastle Utd,29,1992,22,28,14,12,14,2,10,32,31.3,22,287,70,24.4,105,152,30,28,7,0,21,35,63,33,2
Shola Shoretire,eng ENG,FW,Manchester Utd,17,2004,0.2,0,0,0,0,0,0,0,,0,2,0,0,0,1,1,0,0,0,0,0,0,0,0
Francisco Sierralta,cl CHI,DF,Watford,24,1997,4.7,6,4,6,0,0,5,8,62.5,3,24,10,41.7,18,6,0,9,2,0,7,14,20,40,0
Bernardo Silva,pt POR,MFFW,Manchester City,26,1994,31.7,52,33,21,20,11,26,67,38.8,41,480,143,29.8,87,220,173,33,3,0,30,32,84,26,0
Fábio Silva,pt POR,FW,Wolves,19,2002,6.4,6,5,0,3,3,1,6,16.7,5,149,44,29.5,7,80,62,1,0,0,1,4,10,2,0
Thiago Silva,br BRA,DF,Chelsea,36,1984,29.4,36,23,18,15,3,11,25,44,14,173,57,32.9,101,66,6,65,31,3,34,65,101,114,0
Ellis Simms,eng ENG,FW,Everton,20,2001,0.7,0,0,0,0,0,0,0,,0,10,3,30,2,5,3,2,1,0,1,0,0,0,0
Moussa Sissoko,fr FRA,MF,Watford,31,1989,35.8,59,40,34,22,3,19,35,54.3,16,505,160,31.7,177,250,78,53,12,0,41,44,103,72,0
Oliver Skipp,eng ENG,MF,Tottenham,20,2000,15,33,18,14,16,3,12,28,42.9,16,275,71,25.8,109,131,35,25,9,0,16,19,52,14,0
William Smallbone,ie IRL,MFFW,Southampton,21,2000,1.5,6,5,3,3,0,1,5,20,4,44,13,29.5,10,19,15,3,0,0,3,2,8,2,0
Emile Smith Rowe,eng ENG,MFFW,Arsenal,21,2000,21.3,20,16,7,13,0,4,15,26.7,11,256,78,30.5,54,125,77,15,1,0,14,20,40,13,0
Cédric Soares,pt POR,DF,Arsenal,29,1991,16.5,39,20,21,10,8,15,25,60,10,194,68,35.1,76,75,43,24,8,0,16,20,59,35,1
Jakob Sørensen,dk DEN,MFDF,Norwich City,23,1998,6.7,25,16,9,15,1,7,15,46.7,8,125,46,36.8,51,64,10,12,4,0,8,15,40,15,0
Tomáš Souček,cz CZE,MF,West Ham,26,1995,34,68,41,31,29,8,25,68,36.8,43,483,129,26.7,201,220,62,49,15,0,34,55,123,119,1
Boubakary Soumaré,fr FRA,MF,Leicester City,22,1999,12.2,24,13,10,10,4,6,18,33.3,12,250,62,24.8,92,126,32,13,2,0,11,17,41,19,0
Çağlar Söyüncü,tr TUR,DF,Leicester City,25,1996,27.7,52,30,32,17,3,25,41,61,16,259,93,35.9,144,106,9,56,29,0,27,50,102,139,1
Tony Springett,eng ENG,FWMF,Norwich City,18,2002,1.6,3,1,1,1,1,2,4,50,2,48,6,12.5,12,28,8,1,0,0,1,0,3,1,0
Jason Steele,eng ENG,GK,Brighton,30,1990,1,0,0,0,0,0,0,0,,0,0,0,,0,0,0,0,0,0,0,0,0,0,0
Jed Steer,eng ENG,GK,Aston Villa,28,1992,1,0,0,0,0,0,0,0,,0,0,0,,0,0,0,0,0,0,0,0,0,0,0
Zack Steffen,us USA,GK,Manchester City,26,1995,1,0,0,0,0,0,0,0,,0,0,0,,0,0,0,0,0,0,0,0,0,0,0
Dale Stephens,eng ENG,MF,Burnley,32,1989,1.4,7,2,2,4,1,1,5,20,4,41,14,34.1,7,29,5,4,1,0,3,2,9,1,0
Jack Stephens,eng ENG,DF,Southampton,27,1994,9,21,12,11,8,2,6,18,33.3,12,92,33,35.9,56,29,7,16,8,0,8,27,48,46,0
Raheem Sterling,eng ENG,FW,Manchester City,26,1994,23.6,28,18,2,13,13,6,21,28.6,15,317,93,29.3,38,147,132,15,0,0,15,15,43,3,0
Finley Stevens,wls WAL,DF,Brentford,18,2003,0.2,2,0,0,2,0,1,1,100,0,5,1,20,0,4,1,0,0,0,0,0,2,0,0
John Stones,eng ENG,DF,Manchester City,27,1994,12.4,5,4,3,2,0,2,4,50,2,58,22,37.9,23,29,6,9,3,0,6,17,22,41,1
Pascal Struijk,nl NED,DF,Leeds United,21,1999,22.8,68,35,42,22,4,28,50,56,22,387,140,36.2,202,158,27,57,27,0,30,63,131,82,3
Crysencio Summerville,nl NED,MFFW,Leeds United,19,2001,1.4,6,4,2,1,3,3,3,100,0,22,9,40.9,5,7,10,2,0,0,2,5,11,0,0
Japhet Tanganga,eng ENG,DF,Tottenham,22,1999,8.2,21,12,10,6,5,8,13,61.5,5,110,36,32.7,52,45,13,16,7,0,9,17,38,30,0
Matt Targett,eng ENG,DF,Aston Villa,25,1995,15.9,31,15,26,5,0,13,35,37.1,22,191,44,23,107,62,22,44,10,0,34,35,66,25,0
Matt Targett,eng ENG,DF,Newcastle Utd,25,1995,16,40,23,25,13,2,20,35,57.1,15,175,56,32,99,45,31,18,4,1,14,35,75,43,1
James Tarkowski,eng ENG,DF,Burnley,28,1992,34.5,71,42,52,18,1,32,57,56.1,25,261,94,36,176,73,12,92,63,3,29,72,143,216,5
Nuno Tavares,pt POR,DF,Arsenal,21,2000,13.1,20,12,9,7,4,5,10,50,5,155,47,30.3,64,55,36,21,5,0,16,24,44,30,1
Charlie Taylor,eng ENG,DF,Burnley,27,1993,30.3,54,24,33,18,3,28,48,58.3,20,243,62,25.5,130,85,28,95,20,0,75,72,126,84,1
Nathan Tella,eng ENG,MFFW,Southampton,22,1999,8.9,12,5,5,5,2,4,18,22.2,14,269,68,25.3,62,115,92,18,0,0,18,19,31,7,0
Alex Telles,br BRA,DF,Manchester Utd,28,1992,18.4,48,27,37,10,1,19,35,54.3,16,196,60,30.6,106,67,23,29,5,0,24,36,84,53,2
Luke Thomas,eng ENG,DF,Leicester City,20,2001,21.2,48,29,33,10,5,20,52,38.5,32,381,105,27.6,200,136,45,57,15,1,42,40,88,48,1
Dominic Thompson,eng ENG,DF,Brentford,21,2000,1.6,3,1,3,0,0,2,3,66.7,1,16,3,18.8,9,5,2,2,2,0,0,3,6,4,0
Youri Tielemans,be BEL,MF,Leicester City,24,1997,29.2,67,49,24,37,6,30,94,31.9,64,489,146,29.9,164,251,74,47,13,1,34,41,108,42,2
Kieran Tierney,sct SCO,DF,Arsenal,24,1997,21.3,21,12,11,7,3,10,14,71.4,4,162,49,30.2,60,58,44,35,7,0,28,31,52,46,0
Takehiro Tomiyasu,jp JPN,DF,Arsenal,22,1998,18.7,38,17,19,12,7,16,30,53.3,14,221,70,31.7,90,97,34,37,3,0,34,36,74,48,1
James Tomkins,eng ENG,DF,Crystal Palace,32,1989,6.1,12,6,7,5,0,5,7,71.4,2,49,20,40.8,33,16,0,13,8,0,5,10,22,14,0
Ivan Toney,eng ENG,FW,Brentford,25,1996,32.3,31,20,5,16,10,6,25,24,19,457,112,24.5,53,192,212,31,3,1,28,21,52,43,1
Ferrán Torres,es ESP,FW,Manchester City,21,2000,3.4,1,1,0,1,0,0,1,0,1,38,13,34.2,3,8,27,6,1,0,5,1,2,0,0
Cenk Tosun,tr TUR,FW,Everton,30,1991,0.1,0,0,0,0,0,0,0,,0,1,0,0,0,0,1,0,0,0,0,0,0,0,0
Andros Townsend,eng ENG,MF,Everton,30,1991,16.2,29,15,15,9,5,8,35,22.9,27,302,98,32.5,85,128,89,44,3,0,41,21,50,6,0
Adama Traoré,es ESP,FW,Wolves,25,1996,11.9,12,9,7,2,3,2,9,22.2,7,140,42,30,37,68,35,8,1,0,7,4,16,2,0
Bertrand Traoré,bf BFA,MFFW,Aston Villa,25,1995,2.4,2,0,0,0,2,1,3,33.3,2,27,5,18.5,4,5,18,0,0,0,0,0,2,1,0
Trézéguet,eg EGY,FW,Aston Villa,26,1994,0.1,0,0,0,0,0,0,0,,0,0,0,,0,0,0,0,0,0,0,0,0,0,0
Francisco Trincão,pt POR,FWMF,Wolves,21,1999,14.8,29,15,9,13,7,6,14,42.9,8,338,94,27.8,74,169,95,21,1,0,20,15,44,1,0
Kieran Trippier,eng ENG,DF,Newcastle Utd,30,1990,4.8,21,13,11,8,2,10,16,62.5,6,60,18,30,21,31,8,12,3,0,9,11,32,18,0
William Troost-Ekong,ng NGA,DF,Watford,27,1993,15.4,17,10,10,7,0,6,11,54.5,5,106,38,35.8,62,41,3,29,14,1,15,23,40,88,1
Leandro Trossard,be BEL,FWMF,Brighton,26,1994,31.2,37,24,8,13,16,6,32,18.8,26,478,156,32.6,86,178,214,42,4,0,38,29,66,8,0
Kostas Tsimikas,gr GRE,DF,Liverpool,25,1996,9.7,20,10,9,6,5,6,16,37.5,10,137,47,34.3,53,45,39,15,2,0,13,14,34,22,0
Axel Tuanzebe,eng ENG,DF,Aston Villa,23,1997,5.6,8,6,6,2,0,2,5,40,3,47,13,27.7,23,20,4,5,4,0,1,9,17,13,1
Ozan Tufan,tr TUR,MF,Watford,26,1995,3.7,4,2,1,2,1,1,4,25,3,77,9,11.7,23,39,15,5,0,0,5,2,6,4,0
Christos Tzolis,gr GRE,FWMF,Norwich City,19,2002,3.7,6,2,3,3,0,3,10,30,7,69,14,20.3,26,20,23,4,0,0,4,2,8,2,0
Yan Valery,fr FRA,DF,Southampton,22,1999,4.1,10,7,5,4,1,5,11,45.5,6,50,20,40,22,24,4,10,3,0,7,12,22,21,1
Virgil van Dijk,nl NED,DF,Liverpool,30,1991,34,21,12,13,7,1,11,15,73.3,4,124,44,35.5,72,45,7,31,16,1,15,47,68,135,1
Raphaël Varane,fr FRA,DF,Manchester Utd,28,1993,20.3,27,16,17,7,3,10,22,45.5,12,164,58,35.4,112,47,5,32,14,0,18,35,62,95,1
Jamie Vardy,eng ENG,FW,Leicester City,34,1987,20.1,7,4,0,4,3,1,6,16.7,5,275,67,24.4,13,117,145,10,1,0,9,7,14,16,0
Joël Veltman,nl NED,DF,Brighton,29,1992,31.9,90,40,55,29,6,31,64,48.4,33,350,110,31.4,177,137,36,65,16,0,49,67,157,97,1
Jannik Vestergaard,dk DEN,DF,Leicester City,28,1992,6.3,16,11,13,3,0,6,15,40,9,60,22,36.7,45,15,0,15,10,0,5,15,31,41,1
Nikola Vlašić,hr CRO,FWMF,West Ham,23,1997,6.2,13,11,3,8,2,4,20,20,16,150,35,23.3,41,65,44,6,0,0,6,10,23,2,0
Matěj Vydra,cz CZE,FW,Burnley,29,1992,7.5,12,8,3,3,6,3,5,60,2,159,40,25.2,17,62,80,5,1,0,4,3,15,9,0
Theo Walcott,eng ENG,MFFW,Southampton,32,1989,4.2,5,3,2,1,2,3,5,60,2,79,17,21.5,20,35,24,5,0,0,5,7,12,2,0
Kyle Walker,eng ENG,DF,Manchester City,31,1990,19.5,23,16,11,10,2,11,22,50,11,164,56,34.1,53,88,23,20,4,0,16,25,48,24,0
Kyle Walker-Peters,eng ENG,DF,Southampton,24,1997,29.3,63,27,28,26,9,20,36,55.6,16,367,111,30.2,140,148,79,53,9,0,44,56,119,44,1
Aaron Wan-Bissaka,eng ENG,DF,Manchester Utd,23,1997,19.9,46,25,26,13,7,7,18,38.9,11,225,64,28.4,106,78,41,56,15,1,41,51,97,48,0
Danny Ward,wls WAL,GK,Leicester City,28,1993,1,0,0,0,0,0,0,0,,0,0,0,,0,0,0,0,0,0,0,0,0,0,0
Joel Ward,eng ENG,DF,Crystal Palace,31,1989,27.6,48,28,30,17,1,24,51,47.1,27,284,84,29.6,151,96,37,53,12,0,41,54,102,102,1
James Ward-Prowse,eng ENG,MF,Southampton,26,1994,35.7,47,26,16,24,7,13,65,20,52,551,169,30.7,171,297,83,65,15,1,50,60,107,44,1
Ollie Watkins,eng ENG,FW,Aston Villa,25,1995,32.8,17,14,2,7,8,2,10,20,8,578,141,24.4,38,256,284,42,4,0,38,17,34,26,0
Adam Webster,eng ENG,DF,Brighton,26,1995,15.9,23,13,15,6,2,12,22,54.5,10,118,45,38.1,69,41,8,35,18,0,17,25,48,80,2
Wout Weghorst,nl NED,FW,Burnley,28,1992,16.1,17,12,4,9,4,6,20,30,14,518,133,25.7,81,225,212,30,5,0,25,8,25,12,0
Danny Welbeck,eng ENG,FW,Brighton,30,1990,16.4,14,12,1,10,3,2,11,18.2,9,262,90,34.4,29,94,139,20,5,0,15,5,19,18,0
Timo Werner,de GER,FWMF,Chelsea,25,1996,14.3,7,4,0,3,4,0,17,0,17,248,64,25.8,35,86,127,11,1,0,10,4,11,3,0
Ashley Westwood,eng ENG,MF,Burnley,31,1990,25.4,30,23,7,20,3,13,29,44.8,16,434,92,21.2,126,247,61,19,9,0,10,43,73,20,0
Ben White,eng ENG,DF,Arsenal,23,1997,32,42,23,27,11,4,19,43,44.2,24,252,82,32.5,134,95,23,54,26,0,28,66,108,114,0
Brandon Williams,eng ENG,DF,Norwich City,20,2000,23.6,56,29,36,17,3,24,57,42.1,33,317,81,25.6,156,120,41,51,7,0,44,61,117,47,0
Neco Williams,wls WAL,DF,Liverpool,20,2001,0.1,0,0,0,0,0,0,0,,0,1,0,0,1,0,0,0,0,0,0,0,0,0,0
Joe Willock,eng ENG,MF,Newcastle Utd,21,1999,22.6,69,44,31,30,8,22,62,35.5,40,535,118,22.1,168,252,115,38,8,0,30,30,99,16,0
Callum Wilson,eng ENG,FW,Newcastle Utd,29,1992,15.4,8,6,1,3,4,1,4,25,3,190,43,22.6,24,74,92,9,4,0,5,4,12,12,1
Harry Winks,eng ENG,MF,Tottenham,25,1996,10.1,17,7,5,8,4,8,16,50,8,145,32,22.1,51,71,23,18,4,0,14,19,36,8,0
Yoane Wissa,cd COD,FWMF,Brentford,24,1996,14.3,14,8,5,5,4,0,15,0,15,190,54,28.4,36,64,90,16,5,0,11,9,23,8,0
Chris Wood,nz NZL,FW,Newcastle Utd,29,1991,14.7,4,3,1,3,0,1,2,50,1,248,67,27,15,116,117,8,3,0,5,2,6,8,0
Chris Wood,nz NZL,FW,Burnley,29,1991,15.2,11,8,2,5,4,4,8,50,4,198,60,30.3,8,81,109,16,7,0,9,4,15,6,0
Freddie Woodman,eng ENG,GK,Newcastle Utd,24,1997,4,0,0,0,0,0,0,0,,0,1,0,0,1,0,0,0,0,0,0,0,0,0,0
Granit Xhaka,ch SUI,MFDF,Arsenal,28,1992,25.9,39,24,19,14,6,13,36,36.1,23,300,84,28,101,121,78,36,8,0,28,31,70,28,0
Andriy Yarmolenko,ua UKR,FW,West Ham,31,1989,3.5,3,0,1,2,0,3,7,42.9,4,60,12,20,19,19,22,5,2,0,3,1,4,1,0
Ashley Young,eng ENG,DFFW,Aston Villa,36,1985,13.9,28,15,15,9,4,11,14,78.6,3,145,35,24.1,59,56,30,12,4,0,8,22,50,24,0
Nathan Young-Coombes,eng ENG,FW,Brentford,18,2003,0,0,0,0,0,0,0,0,,0,2,0,0,1,1,0,0,0,0,0,0,0,0,0
Wilfried Zaha,ci CIV,FW,Crystal Palace,28,1992,30.7,48,35,15,22,11,9,28,32.1,19,622,174,28,137,307,178,27,0,0,27,24,72,4,0
Christoph Zimmermann,de GER,DF,Norwich City,28,1993,1.7,5,3,3,2,0,2,4,50,2,24,9,37.5,13,8,3,0,0,0,0,3,8,3,0
Oleksandr Zinchenko,ua UKR,DF,Manchester City,24,1996,11.6,20,11,7,10,3,4,13,30.8,9,94,31,33,25,47,22,18,3,0,15,18,38,13,1
Hakim Ziyech,ma MAR,FWMF,Chelsea,28,1993,14.7,20,11,5,11,4,4,25,16,21,266,78,29.3,53,118,95,18,1,0,17,20,40,9,0
Kurt Zouma,fr FRA,DF,West Ham,26,1994,23.1,11,5,9,2,0,4,8,50,4,107,35,32.7,58,36,13,38,27,0,11,47,58,140,0
